Source Port,Destination Port,NAT Source Port,NAT Destination Port,Bytes,Bytes Sent,Bytes Received,Packets,Elapsed Time (sec),pkts_sent,pkts_received
50626,443,22681,443,1604,987,617,16,93,9,7
51587,445,0,0,70,70,0,1,0,1,0
9337,443,53921,443,428,128,300,8,47,3,5
13554,44847,0,0,62,62,0,1,0,1,0
60985,443,19268,443,20423,4091,16332,33,122,15,18
60646,11392,0,0,66,66,0,1,0,1,0
21420,44847,0,0,66,66,0,1,0,1,0
58075,445,0,0,70,70,0,1,0,1,0
52051,29868,56419,29868,70,70,0,2,8,2,0
63368,445,0,0,66,66,0,1,0,1,0
50721,445,0,0,66,66,0,1,0,1,0
49558,53,29414,53,177,94,83,2,30,1,1
37271,443,4038,443,51402,5964,45438,86,153,32,54
44246,80,45320,80,5584,2543,3041,20,27,11,9
64355,53,49915,53,402,118,284,2,29,1,1
50397,445,0,0,66,66,0,1,0,1,0
51179,445,0,0,66,66,0,1,0,1,0
43584,24748,0,0,156,156,0,1,0,1,0
1026,30188,0,0,146,146,0,1,0,1,0
51310,64147,0,0,62,62,0,1,0,1,0
51960,443,7003,443,8830,1950,6880,27,25,14,13
56977,80,20065,80,214,140,74,4,35,3,1
16221,50584,0,0,62,62,0,1,0,1,0
57020,36237,0,0,66,66,0,1,0,1,0
52348,62413,0,0,66,66,0,1,0,1,0
64073,53,53984,53,304,101,203,4,37,2,2
53143,443,21953,443,4962,887,4075,15,28,9,6
63925,37965,0,0,66,66,0,1,0,1,0
45941,23388,0,0,60,60,0,1,0,1,0
55457,443,46084,443,8447,2129,6318,26,250,15,11
50052,65008,0,0,60,60,0,1,0,1,0
24285,26467,0,0,62,62,0,1,0,1,0
50348,443,42997,443,1385,868,517,12,30,6,6
52324,443,60831,443,295493,16052,279441,394,68,186,208
14715,56205,0,0,62,62,0,1,0,1,0
52626,44847,0,0,66,66,0,1,0,1,0
50125,445,0,0,66,66,0,1,0,1,0
4296,53,43153,53,217,86,131,2,30,1,1
44884,443,49689,443,296,78,218,4,19,1,3
50936,445,0,0,70,70,0,1,0,1,0
62914,11392,0,0,146,146,0,1,0,1,0
64334,25174,0,0,66,66,0,1,0,1,0
39524,10104,0,0,137,137,0,1,0,1,0
53910,445,0,0,70,70,0,1,0,1,0
54898,36237,0,0,66,66,0,1,0,1,0
49319,53,1935,53,166,86,80,2,29,1,1
37555,16386,35583,16386,432,192,240,8,30,4,4
51120,445,0,0,66,66,0,1,0,1,0
32820,443,45406,443,11455,5836,5619,40,317,20,20
36656,64147,0,0,62,62,0,1,0,1,0
43215,443,55751,443,3245691,49693,3195998,2856,38,666,2190
33641,443,2360,443,15017,6951,8066,49,20,25,24
55727,43736,4643,43736,70,70,0,2,8,2,0
16387,49252,0,0,60,60,0,1,0,1,0
56757,53,39521,53,167,86,81,2,30,1,1
58444,445,0,0,70,70,0,1,0,1,0
55211,53,32834,53,183,94,89,2,30,1,1
49629,53,19594,53,916,86,830,2,30,1,1
26884,37965,0,0,66,66,0,1,0,1,0
50033,445,0,0,70,70,0,1,0,1,0
53446,445,0,0,70,70,0,1,0,1,0
57789,30188,0,0,62,62,0,1,0,1,0
52496,445,0,0,70,70,0,1,0,1,0
49385,53,9929,53,843,285,558,8,56,4,4
50227,57470,0,0,66,66,0,1,0,1,0
55763,53,36537,53,197,94,103,2,31,1,1
64090,443,49482,443,7360,2435,4925,19,135,9,10
9244,80,12299,80,318,192,126,6,26,4,2
1369,48817,0,0,145,145,0,1,0,1,0
55689,443,55689,443,177498,9805,167693,244,80,119,125
40360,443,31288,443,3146,766,2380,10,120,5,5
56612,53,25509,53,274,87,187,4,31,2,2
50584,51413,41920,51413,475,150,325,2,1200,1,1
6666,3389,0,0,60,60,0,1,0,1,0
25457,25604,0,0,62,62,0,1,0,1,0
63282,445,0,0,70,70,0,1,0,1,0
58381,57470,0,0,66,66,0,1,0,1,0
63595,443,51163,443,8062,2186,5876,29,136,15,14
55555,445,0,0,70,70,0,1,0,1,0
56637,443,26633,443,7907,1918,5989,20,15,11,9
44258,25,0,0,74,74,0,1,0,1,0
52323,443,4848,443,454059,23387,430672,602,76,275,327
64045,7426,33466,7426,70,70,0,1,4,1,0
49219,443,60965,443,70,70,0,2,4,2,0
51830,32787,47434,32787,70,70,0,2,6,2,0
51787,35661,32624,35661,70,70,0,2,8,2,0
21606,80,0,0,60,60,0,1,0,1,0
57625,443,18316,443,4751,909,3842,15,16,9,6
50383,445,0,0,70,70,0,1,0,1,0
62724,445,0,0,70,70,0,1,0,1,0
4269,26672,0,0,60,60,0,1,0,1,0
59155,39004,0,0,74,74,0,1,0,1,0
11256,47967,0,0,143,143,0,1,0,1,0
36146,443,42647,443,2514,1249,1265,19,76,9,10
21846,53,21846,53,247,98,149,2,33,1,1
53626,33194,63366,33194,70,70,0,1,4,1,0
64617,53,32317,53,756,95,661,2,30,1,1
60850,445,0,0,70,70,0,1,0,1,0
50884,443,50884,443,187790,7733,180057,229,128,90,139
27490,53,27490,53,214,82,132,2,33,1,1
56213,26467,0,0,62,62,0,1,0,1,0
48756,80,48756,80,560,264,296,9,44,5,4
57470,51413,18747,51413,604,275,329,4,1199,2,2
65361,53,33877,53,760,97,663,2,30,1,1
49902,445,0,0,70,70,0,1,0,1,0
49584,80,44285,80,318,192,126,6,42,4,2
57164,50584,0,0,62,62,0,1,0,1,0
49206,12242,32509,12242,70,70,0,2,8,2,0
49506,443,13324,443,6002,1965,4037,23,270,11,12
33006,80,33006,80,6582,886,5696,15,16,7,8
65401,445,0,0,66,66,0,1,0,1,0
59680,445,0,0,70,70,0,1,0,1,0
59832,445,0,0,70,70,0,1,0,1,0
22773,443,22773,443,6993,960,6033,17,31,10,7
54519,443,46768,443,70,70,0,1,5,1,0
58151,443,48543,443,6563,1656,4907,22,318,13,9
57210,8525,57210,8525,138,78,60,2,5,1,1
55028,443,3475,443,1403116,30089,1373027,1321,32,404,917
50468,80,2157,80,314,192,122,6,28,4,2
50759,53,62224,53,578,286,292,9,16,5,4
65136,53,36348,53,438,180,258,6,30,3,3
63943,445,0,0,66,66,0,1,0,1,0
61085,37965,0,0,62,62,0,1,0,1,0
57448,53,27842,53,177,94,83,2,29,1,1
2547,53,2547,53,194,87,107,2,30,1,1
55443,53,18885,53,194,102,92,2,30,1,1
59129,445,0,0,70,70,0,1,0,1,0
55826,53,63992,53,168,86,82,2,30,1,1
46495,4607,0,0,60,60,0,1,0,1,0
58638,5900,0,0,62,62,0,1,0,1,0
51315,445,0,0,66,66,0,1,0,1,0
55893,53,24260,53,267,94,173,4,55,2,2
46286,21247,0,0,146,146,0,1,0,1,0
52802,56205,0,0,66,66,0,1,0,1,0
56331,443,61535,443,1786,172,1614,7,121,3,4
49931,25174,0,0,62,62,0,1,0,1,0
49262,53,13310,53,168,86,82,2,29,1,1
61609,445,0,0,70,70,0,1,0,1,0
51900,80,40398,80,366,240,126,7,29,5,2
56660,443,12588,443,1579,988,591,13,25,7,6
1114,46824,0,0,62,62,0,1,0,1,0
7222,57470,0,0,62,62,0,1,0,1,0
55692,53,51127,53,198,102,96,2,30,1,1
62282,445,0,0,66,66,0,1,0,1,0
55463,53,9844,53,216,110,106,2,31,1,1
64255,53,15083,53,260,86,174,2,30,1,1
56692,443,32743,443,3932,2581,1351,18,18,10,8
61735,443,32889,443,57467,4506,52961,86,30,42,44
27515,53,18456,53,224,78,146,2,30,1,1
37648,443,15216,443,9618,7387,2231,30,26,18,12
57377,53,64833,53,1165,94,1071,2,30,1,1
51448,80,39374,80,214,140,74,4,15,3,1
58305,51180,0,0,66,66,0,1,0,1,0
14696,42707,0,0,62,62,0,1,0,1,0
64004,445,0,0,70,70,0,1,0,1,0
53710,27935,28057,27935,70,70,0,2,7,2,0
55777,445,0,0,70,70,0,1,0,1,0
50994,35974,0,0,60,60,0,1,0,1,0
58835,445,0,0,70,70,0,1,0,1,0
57990,443,7309,443,3182,1568,1614,8,120,4,4
12530,35440,0,0,66,66,0,1,0,1,0
54034,443,22227,443,43491,8521,34970,69,50,34,35
63895,445,0,0,70,70,0,1,0,1,0
57371,53,9888,53,755,93,662,2,31,1,1
56380,53,36495,53,177,94,83,2,30,1,1
56630,80,55230,80,234,234,0,4,12,4,0
54349,443,33751,443,14063,6328,7735,33,37,16,17
4111,25174,0,0,62,62,0,1,0,1,0
50024,445,0,0,70,70,0,1,0,1,0
64952,445,0,0,70,70,0,1,0,1,0
39107,443,62182,443,692830,23263,669567,784,114,306,478
0,0,0,0,200,102,98,2,0,1,1
60000,80,0,0,60,60,0,1,0,1,0
55955,53,2221,53,814,110,704,2,30,1,1
62620,445,0,0,66,66,0,1,0,1,0
52332,445,0,0,70,70,0,1,0,1,0
55062,53,13920,53,733,86,647,2,31,1,1
50871,445,0,0,70,70,0,1,0,1,0
63705,19652,30539,19652,70,70,0,1,5,1,0
58667,445,0,0,70,70,0,1,0,1,0
56775,53,45440,53,177,94,83,2,30,1,1
56628,445,0,0,70,70,0,1,0,1,0
56288,445,0,0,70,70,0,1,0,1,0
64161,53,62669,53,261,102,159,2,30,1,1
64967,53,8909,53,184,94,90,2,29,1,1
55684,80,48603,80,70,70,0,1,5,1,0
46346,35440,0,0,66,66,0,1,0,1,0
64877,53,24917,53,182,93,89,2,31,1,1
62498,443,43471,443,14786,3978,10808,32,26,15,17
60989,445,0,0,66,66,0,1,0,1,0
55308,53,65535,53,194,94,100,2,30,1,1
58996,445,0,0,70,70,0,1,0,1,0
49488,53,49488,53,823,98,725,2,30,1,1
53245,80,62504,80,2071,1305,766,10,256,6,4
43536,443,9827,443,13710,4975,8735,22,121,9,13
46593,28678,34181,28678,1806,1806,0,22,224,22,0
58610,53,58610,53,244,98,146,2,32,1,1
50757,64147,0,0,62,62,0,1,0,1,0
56754,53,65237,53,183,94,89,2,30,1,1
49167,80,49167,80,1915,1466,449,10,20,6,4
59830,443,59830,443,21205,1711,19494,32,1806,11,21
57744,53,14767,53,198,93,105,2,31,1,1
55888,445,0,0,70,70,0,1,0,1,0
22321,80,22321,80,490,264,226,8,26,5,3
51932,36498,40161,36498,70,70,0,1,5,1,0
49765,53,55763,53,188,96,92,2,31,1,1
56062,53,16578,53,744,89,655,2,31,1,1
22439,25174,0,0,66,66,0,1,0,1,0
50228,443,34666,443,1775,169,1606,7,120,3,4
52142,445,0,0,70,70,0,1,0,1,0
50853,50584,0,0,62,62,0,1,0,1,0
55972,53,18787,53,193,102,91,2,31,1,1
36858,443,39662,443,3789,2373,1416,24,26,14,10
57157,53,8214,53,165,86,79,2,30,1,1
10627,23117,0,0,66,66,0,1,0,1,0
50298,445,0,0,70,70,0,1,0,1,0
59694,50584,0,0,62,62,0,1,0,1,0
51973,12321,46700,12321,1260,636,624,9,30,5,4
53035,5228,40515,5228,2725,1610,1115,20,3600,10,10
42986,25174,0,0,66,66,0,1,0,1,0
50690,445,0,0,70,70,0,1,0,1,0
49522,53,16817,53,688,185,503,6,45,3,3
53529,445,0,0,70,70,0,1,0,1,0
55031,53,63225,53,756,95,661,2,31,1,1
52126,443,21159,443,1672,1149,523,13,37,8,5
49246,53,51289,53,164,86,78,2,31,1,1
63775,445,0,0,66,66,0,1,0,1,0
55157,7302,0,0,66,66,0,1,0,1,0
49211,445,0,0,70,70,0,1,0,1,0
53746,7546,50898,7546,70,70,0,1,4,1,0
1847,64147,0,0,62,62,0,1,0,1,0
49623,443,17482,443,3972,2532,1440,18,80,10,8
62627,445,0,0,70,70,0,1,0,1,0
56704,80,26438,80,1146417,29701,1116716,1218,54,422,796
30948,50584,0,0,146,146,0,1,0,1,0
56219,53,57925,53,177,94,83,2,30,1,1
49719,443,28042,443,4717,849,3868,15,52,7,8
63816,2073,59297,2073,70,70,0,1,4,1,0
3478,61463,0,0,1012,1012,0,1,0,1,0
64201,53,54602,53,434,96,338,4,30,2,2
62670,445,0,0,70,70,0,1,0,1,0
53433,445,0,0,66,66,0,1,0,1,0
53437,44847,0,0,66,66,0,1,0,1,0
64879,53,13290,53,165,86,79,2,30,1,1
64075,1026,24378,1026,70,70,0,1,4,1,0
56056,53,19190,53,184,86,98,2,30,1,1
60015,445,0,0,70,70,0,1,0,1,0
6773,57470,0,0,62,62,0,1,0,1,0
57892,80,46739,80,6519,1210,5309,15,17,8,7
60004,445,0,0,70,70,0,1,0,1,0
40299,443,53474,443,9574,2600,6974,29,136,16,13
59143,445,0,0,66,66,0,1,0,1,0
55373,53,47253,53,164,86,78,2,31,1,1
60066,80,60066,80,355862,9048,346814,358,163,116,242
6666,2222,0,0,60,60,0,1,0,1,0
62288,445,0,0,66,66,0,1,0,1,0
50576,53,22318,53,765,102,663,2,29,1,1
60318,123,6592,123,184,94,90,2,30,1,1
49654,53,26382,53,184,94,90,2,30,1,1
2467,2767,0,0,62,62,0,1,0,1,0
64573,53,39960,53,184,94,90,2,30,1,1
49814,445,0,0,70,70,0,1,0,1,0
55384,53,51117,53,194,102,92,2,30,1,1
49224,53,25602,53,199,102,97,2,30,1,1
51490,445,0,0,66,66,0,1,0,1,0
50828,443,8189,443,178483,7778,170705,219,218,90,129
57127,53,17390,53,193,102,91,2,31,1,1
26900,27017,50644,27017,422,164,258,6,30,3,3
57173,44847,0,0,62,62,0,1,0,1,0
37626,443,10434,443,7766,1810,5956,24,46,14,10
54446,445,0,0,70,70,0,1,0,1,0
51947,443,7702,443,3893,2046,1847,29,56,16,13
34146,51221,0,0,62,62,0,1,0,1,0
50875,53,21370,53,78,78,0,1,30,1,0
40651,443,45721,443,41517,28432,13085,89,601,47,42
55046,443,8809,443,23425,10763,12662,57,48,31,26
42231,57470,0,0,78,78,0,1,0,1,0
50371,443,40015,443,456,390,66,4,0,3,1
57294,53,3249,53,760,97,663,2,31,1,1
56426,53,8485,53,184,94,90,2,30,1,1
64965,27049,54387,27049,747,462,285,2,31,1,1
65186,27126,54671,27126,268,78,190,2,30,1,1
50,64147,0,0,62,62,0,1,0,1,0
54636,26467,0,0,62,62,0,1,0,1,0
49300,53,25911,53,232,86,146,2,30,1,1
53648,31637,17348,31637,70,70,0,2,7,2,0
53793,53,24147,53,213,78,135,2,30,1,1
4323,64147,0,0,66,66,0,1,0,1,0
59779,443,38576,443,142,142,0,1,5,1,0
51938,11218,41228,11218,70,70,0,1,5,1,0
49417,38558,0,0,66,66,0,1,0,1,0
57071,53,61611,53,164,84,80,2,31,1,1
30729,22114,0,0,66,66,0,1,0,1,0
57470,6885,1463,6885,616,414,202,5,1200,3,2
54948,445,0,0,70,70,0,1,0,1,0
58638,5900,0,0,62,62,0,1,0,1,0
63237,443,45268,443,1369,670,699,17,141,9,8
57603,80,12542,80,886,886,0,1,120,1,0
45079,31573,0,0,62,62,0,1,0,1,0
63467,37807,0,0,62,62,0,1,0,1,0
4760,44847,0,0,62,62,0,1,0,1,0
64125,53,18557,53,199,102,97,2,30,1,1
50594,80,50594,80,9937,4191,5746,27,17,13,14
53620,443,60649,443,15422,1623,13799,34,18,14,20
49357,80,5006,80,3014,1052,1962,14,97,9,5
52178,445,0,0,70,70,0,1,0,1,0
60219,445,0,0,70,70,0,1,0,1,0
63840,36829,0,0,62,62,0,1,0,1,0
993,54748,0,0,66,66,0,1,0,1,0
30188,64511,50224,64511,854,150,704,4,1200,2,2
64899,53,35861,53,198,101,97,2,30,1,1
50298,443,51193,443,11984,6772,5212,52,222,30,22
64930,53,64696,53,186,95,91,2,31,1,1
52035,80,61330,80,4185,3462,723,14,15,7,7
62597,445,0,0,70,70,0,1,0,1,0
65204,53,23706,53,183,94,89,2,30,1,1
64701,445,0,0,70,70,0,1,0,1,0
59147,51505,0,0,66,66,0,1,0,1,0
65376,53,60931,53,184,94,90,2,30,1,1
50655,80,3910,80,1507,682,825,13,20,8,5
27005,27015,27381,27015,887,126,761,2,30,1,1
64233,53,2922,53,257,126,131,2,29,1,1
54970,445,0,0,66,66,0,1,0,1,0
59592,445,0,0,70,70,0,1,0,1,0
53096,445,0,0,66,66,0,1,0,1,0
49210,53,44765,53,183,94,89,2,30,1,1
55190,443,14814,443,12801,4250,8551,40,118,21,19
33305,54532,0,0,60,60,0,1,0,1,0
57432,443,39026,443,2714,336,2378,10,120,5,5
40848,8434,40848,8434,156,156,0,3,8,3,0
58910,445,0,0,70,70,0,1,0,1,0
3399,25174,0,0,66,66,0,1,0,1,0
19838,23,0,0,60,60,0,1,0,1,0
56307,52700,0,0,66,66,0,1,0,1,0
62140,445,0,0,70,70,0,1,0,1,0
57928,30188,0,0,146,146,0,1,0,1,0
56661,53,53473,53,297,102,195,4,34,2,2
49765,53,13036,53,194,102,92,2,31,1,1
50868,445,0,0,70,70,0,1,0,1,0
59390,53,43106,53,184,86,98,2,31,1,1
24037,443,24037,443,3611,2177,1434,24,17,13,11
44861,443,14296,443,1625,1038,587,14,27,8,6
3270,35440,0,0,66,66,0,1,0,1,0
63943,445,0,0,70,70,0,1,0,1,0
51609,37807,0,0,62,62,0,1,0,1,0
56854,445,0,0,70,70,0,1,0,1,0
37927,50265,0,0,66,66,0,1,0,1,0
49537,53,46669,53,269,96,173,4,59,2,2
47888,2310,0,0,145,145,0,1,0,1,0
55932,445,0,0,66,66,0,1,0,1,0
54504,445,0,0,66,66,0,1,0,1,0
60554,445,0,0,70,70,0,1,0,1,0
59925,443,55867,443,10302,3853,6449,27,61,16,11
1865,25174,0,0,62,62,0,1,0,1,0
11716,37965,0,0,62,62,0,1,0,1,0
55697,445,0,0,70,70,0,1,0,1,0
64106,445,0,0,66,66,0,1,0,1,0
64535,37965,0,0,62,62,0,1,0,1,0
28549,53,28549,53,194,87,107,2,30,1,1
54710,445,0,0,66,66,0,1,0,1,0
57255,443,56046,443,36865,3692,33173,61,47,30,31
63888,57470,0,0,62,62,0,1,0,1,0
63937,445,0,0,70,70,0,1,0,1,0
56070,53,35943,53,770,101,669,2,30,1,1
42599,443,19054,443,215284,28807,186477,346,129,151,195
54262,445,0,0,70,70,0,1,0,1,0
64128,53,26433,53,193,102,91,2,30,1,1
49183,53,29082,53,451,91,360,4,36,2,2
51172,443,45149,443,1472,965,507,13,20,7,6
50224,445,0,0,70,70,0,1,0,1,0
51857,40561,47310,40561,70,70,0,1,5,1,0
61706,64147,0,0,62,62,0,1,0,1,0
48798,443,34647,443,55560,11338,44222,90,23,41,49
65189,27015,36838,27015,257,78,179,2,30,1,1
50328,22114,0,0,66,66,0,1,0,1,0
56215,445,0,0,70,70,0,1,0,1,0
49885,445,0,0,70,70,0,1,0,1,0
31675,23,0,0,60,60,0,1,0,1,0
57633,50584,0,0,146,146,0,1,0,1,0
1027,25174,0,0,146,146,0,1,0,1,0
60479,25174,0,0,62,62,0,1,0,1,0
64587,53,28928,53,166,85,81,2,30,1,1
49297,80,62329,80,16249,1328,14921,28,45,14,14
36484,67,0,0,60,60,0,1,0,1,0
1046,48817,0,0,62,62,0,1,0,1,0
60342,445,0,0,66,66,0,1,0,1,0
55088,53,34841,53,177,94,83,2,30,1,1
443,49988,0,0,82,82,0,1,0,1,0
53090,445,0,0,70,70,0,1,0,1,0
50172,53,37056,53,211,78,133,2,30,1,1
22,37469,22,37469,178,118,60,2,4,1,1
41474,443,57047,443,2767442,82304,2685138,2961,85,1088,1873
53696,50321,3484,50321,70,70,0,1,4,1,0
50843,445,0,0,70,70,0,1,0,1,0
53559,445,0,0,70,70,0,1,0,1,0
52626,44847,0,0,66,66,0,1,0,1,0
2850,64147,0,0,66,66,0,1,0,1,0
55821,53,40795,53,196,102,94,2,30,1,1
55081,53,2837,53,711,87,624,2,31,1,1
45941,23386,0,0,60,60,0,1,0,1,0
49487,445,0,0,70,70,0,1,0,1,0
49781,53,14753,53,194,102,92,2,30,1,1
49678,80,44529,80,1977,921,1056,9,15,5,4
57761,15503,0,0,66,66,0,1,0,1,0
46292,42873,0,0,72,72,0,1,0,1,0
64560,53,45431,53,807,94,713,2,30,1,1
45562,5228,50425,5228,29298,3627,25671,67,5346,25,42
58282,445,0,0,66,66,0,1,0,1,0
52033,443,12817,443,9609,3239,6370,25,143,12,13
56922,53,43765,53,86,86,0,1,30,1,0
64155,60043,0,0,66,66,0,1,0,1,0
54071,50265,0,0,62,62,0,1,0,1,0
50437,3389,50437,3389,3444,1730,1714,16,31,8,8
53640,28937,48559,28937,70,70,0,2,8,2,0
53861,53065,16335,53065,70,70,0,2,8,2,0
54703,53,49581,53,168,78,90,2,30,1,1
53870,445,0,0,70,70,0,1,0,1,0
58729,443,41982,443,5167,700,4467,16,15,7,9
1057,57470,0,0,62,62,0,1,0,1,0
53513,51354,18257,51354,70,70,0,1,4,1,0
0,0,0,0,70,70,0,1,0,1,0
59685,445,0,0,70,70,0,1,0,1,0
55098,53,8835,53,176,90,86,2,30,1,1
50440,53,52778,53,458,188,270,6,29,3,3
5285,64147,0,0,145,145,0,1,0,1,0
55002,53,54595,53,192,98,94,2,31,1,1
60973,443,19022,443,398300,18473,379827,492,72,222,270
59215,445,0,0,66,66,0,1,0,1,0
64331,53,61619,53,179,94,85,2,30,1,1
50751,445,0,0,70,70,0,1,0,1,0
41462,443,16265,443,3467,2269,1198,21,82,11,10
43762,443,5128,443,7775,1963,5812,22,77,13,9
51825,25501,11280,25501,70,70,0,2,9,2,0
9322,443,10424,443,4106,703,3403,15,26,8,7
33405,37965,0,0,62,62,0,1,0,1,0
52973,57470,0,0,74,74,0,1,0,1,0
17428,3389,17428,3389,4695,2520,2175,22,19,13,9
49511,443,56126,443,1200,623,577,13,27,6,7
64913,53,34114,53,211,102,109,2,30,1,1
56709,443,60934,443,1239919,29325,1210594,1214,46,409,805
56924,53,57471,53,177,94,83,2,30,1,1
55794,443,55794,443,4578,1671,2907,19,28,11,8
55808,53,26919,53,179,94,85,2,30,1,1
59780,445,0,0,70,70,0,1,0,1,0
57472,44847,0,0,66,66,0,1,0,1,0
62003,445,0,0,66,66,0,1,0,1,0
65258,53,18646,53,763,102,661,2,30,1,1
60727,445,0,0,70,70,0,1,0,1,0
65289,53,7871,53,179,94,85,2,31,1,1
27785,37965,0,0,66,66,0,1,0,1,0
45941,23386,0,0,60,60,0,1,0,1,0
48071,25174,0,0,62,62,0,1,0,1,0
51236,445,0,0,70,70,0,1,0,1,0
51443,443,36286,443,70,70,0,1,5,1,0
0,0,0,0,74,74,0,1,0,1,0
61181,445,0,0,70,70,0,1,0,1,0
63386,445,0,0,66,66,0,1,0,1,0
55022,53,30402,53,772,103,669,2,30,1,1
50920,60182,0,0,66,66,0,1,0,1,0
52258,445,0,0,70,70,0,1,0,1,0
54440,26467,0,0,66,66,0,1,0,1,0
64095,53,19951,53,170,87,83,2,30,1,1
60923,49903,0,0,66,66,0,1,0,1,0
49342,53,62127,53,200,102,98,2,30,1,1
59522,443,54778,443,8743,2676,6067,30,25,16,14
51374,30317,0,0,62,62,0,1,0,1,0
58638,5900,0,0,62,62,0,1,0,1,0
54976,443,13251,443,8156,3281,4875,43,71,21,22
54298,48983,0,0,159,159,0,1,0,1,0
50185,443,5992,443,6350,1071,5279,18,42,10,8
49663,53,12596,53,190,97,93,2,31,1,1
53713,26085,43109,26085,70,70,0,2,7,2,0
25237,53,25237,53,216,82,134,2,33,1,1
55482,53,16639,53,822,102,720,2,30,1,1
3212,22114,0,0,146,146,0,1,0,1,0
51348,25174,0,0,66,66,0,1,0,1,0
50288,445,0,0,66,66,0,1,0,1,0
56621,443,45506,443,7981,1961,6020,20,15,11,9
51004,445,0,0,66,66,0,1,0,1,0
64104,445,0,0,70,70,0,1,0,1,0
55932,53,10932,53,193,102,91,2,29,1,1
27727,53,27727,53,407,261,146,3,32,2,1
27005,27025,23287,27025,895,126,769,2,30,1,1
64036,23718,0,0,66,66,0,1,0,1,0
50233,80,29881,80,2388,1066,1322,16,135,8,8
55609,39869,9261,39869,70,70,0,2,8,2,0
64500,53,31734,53,212,102,110,2,30,1,1
51194,445,0,0,70,70,0,1,0,1,0
56152,56205,0,0,66,66,0,1,0,1,0
38084,443,21809,443,2697,1520,1177,21,182,10,11
25565,62778,0,0,60,60,0,1,0,1,0
56496,53,41605,53,193,102,91,2,30,1,1
53034,53,25305,53,238,94,144,2,30,1,1
59526,445,0,0,70,70,0,1,0,1,0
57726,445,0,0,70,70,0,1,0,1,0
60864,5223,21557,5223,6278,2408,3870,27,3600,15,12
53808,56215,39390,56215,70,70,0,2,7,2,0
57240,53,57857,53,215,94,121,2,30,1,1
60823,25174,0,0,66,66,0,1,0,1,0
55498,53,29212,53,177,94,83,2,30,1,1
52432,443,37828,443,330,190,140,6,15,4,2
49418,27015,59160,27015,78,78,0,1,30,1,0
55615,13826,16730,13826,70,70,0,1,5,1,0
53765,443,33408,443,499,425,74,4,0,3,1
2990,64147,0,0,66,66,0,1,0,1,0
50705,445,0,0,70,70,0,1,0,1,0
33305,53,29793,53,168,78,90,2,30,1,1
53789,53,48550,53,168,78,90,2,30,1,1
40906,443,50326,443,8138,2333,5805,26,106,14,12
63742,445,0,0,70,70,0,1,0,1,0
58808,443,58470,443,5167,700,4467,16,15,7,9
50584,12899,63307,12899,166,166,0,1,1200,1,0
59125,445,0,0,66,66,0,1,0,1,0
49534,53,33345,53,186,95,91,2,31,1,1
63811,443,59225,443,25707,7559,18148,53,121,24,29
60397,443,49717,443,7643,1678,5965,21,80,11,10
65048,53,54954,53,754,94,660,2,31,1,1
64842,53,15693,53,340,95,245,4,47,2,2
65380,53,11853,53,176,90,86,2,31,1,1
57339,445,0,0,70,70,0,1,0,1,0
8592,35993,0,0,66,66,0,1,0,1,0
56198,443,56198,443,27729,5508,22221,60,18,31,29
45144,25174,0,0,62,62,0,1,0,1,0
57689,443,27070,443,10855,1786,9069,32,180,15,17
62431,445,0,0,66,66,0,1,0,1,0
54991,443,64659,443,15109,5866,9243,71,362,29,42
55926,53,60455,53,184,94,90,2,30,1,1
55824,53,60939,53,819,102,717,2,30,1,1
53145,44634,36222,44634,70,70,0,1,5,1,0
50507,445,0,0,70,70,0,1,0,1,0
55197,53,53428,53,701,88,613,2,31,1,1
55354,53,26809,53,212,108,104,2,31,1,1
34993,15503,0,0,62,62,0,1,0,1,0
52026,26467,0,0,60,60,0,1,0,1,0
49434,53,25380,53,183,86,97,2,29,1,1
36417,443,64743,443,8611,2046,6565,31,394,10,21
57346,445,0,0,66,66,0,1,0,1,0
36215,443,40898,443,3554,2208,1346,18,256,10,8
49418,27015,25961,27015,234,78,156,2,30,1,1
19885,64147,0,0,62,62,0,1,0,1,0
51739,62163,31026,62163,70,70,0,2,8,2,0
56613,445,0,0,70,70,0,1,0,1,0
62571,445,0,0,70,70,0,1,0,1,0
54756,445,0,0,70,70,0,1,0,1,0
63092,46776,0,0,78,78,0,1,0,1,0
59868,445,0,0,70,70,0,1,0,1,0
52583,445,0,0,70,70,0,1,0,1,0
40967,1433,0,0,60,60,0,1,0,1,0
6247,51221,0,0,62,62,0,1,0,1,0
52741,24211,0,0,66,66,0,1,0,1,0
51930,445,0,0,70,70,0,1,0,1,0
55598,445,0,0,70,70,0,1,0,1,0
63210,445,0,0,70,70,0,1,0,1,0
63591,443,24703,443,11746,3874,7872,44,141,22,22
56308,53,37236,53,184,94,90,2,31,1,1
49373,445,0,0,70,70,0,1,0,1,0
49487,53,55528,53,183,94,89,2,30,1,1
58246,445,0,0,66,66,0,1,0,1,0
4793,50584,0,0,62,62,0,1,0,1,0
0,0,0,0,320,320,0,5,0,5,0
57232,53,10597,53,821,102,719,2,30,1,1
54219,443,4628,443,499,425,74,4,0,3,1
55549,53,20623,53,209,110,99,2,30,1,1
26921,26467,0,0,62,62,0,1,0,1,0
64725,445,0,0,70,70,0,1,0,1,0
27005,27013,41883,27013,879,126,753,2,30,1,1
44808,443,1785,443,22366,9583,12783,50,37,25,25
55102,53,13108,53,195,102,93,2,29,1,1
51989,80,9142,80,1344,899,445,8,15,6,2
49205,53,19317,53,194,102,92,2,31,1,1
56765,53,6433,53,194,102,92,2,30,1,1
57076,445,0,0,66,66,0,1,0,1,0
49580,445,0,0,70,70,0,1,0,1,0
54323,445,0,0,66,66,0,1,0,1,0
65209,53,37823,53,166,86,80,2,31,1,1
64283,53,27743,53,193,102,91,2,30,1,1
52030,443,43838,443,9090,1914,7176,24,25,13,11
8282,17435,17967,17435,73,73,0,1,30,1,0
11235,30188,0,0,66,66,0,1,0,1,0
58302,443,37691,443,4611,3176,1435,26,30,15,11
52385,53,0,0,139,70,69,2,30,1,1
11716,37965,0,0,62,62,0,1,0,1,0
65004,53,23515,53,323,94,229,2,30,1,1
60053,53,50009,53,199,94,105,2,30,1,1
64312,53,19518,53,209,110,99,2,30,1,1
64339,18375,0,0,66,66,0,1,0,1,0
50197,64147,0,0,66,66,0,1,0,1,0
53964,445,0,0,70,70,0,1,0,1,0
53831,443,42938,443,190,70,120,4,15,2,2
50611,443,62610,443,11152,2086,9066,33,93,17,16
55265,53,19057,53,740,93,647,2,31,1,1
56858,32330,62382,32330,70,70,0,2,8,2,0
52942,443,55996,443,14696,5947,8749,53,115,26,27
54002,445,0,0,70,70,0,1,0,1,0
37889,53,32762,53,199,94,105,2,30,1,1
52337,445,0,0,70,70,0,1,0,1,0
58054,445,0,0,70,70,0,1,0,1,0
55173,445,0,0,70,70,0,1,0,1,0
55040,443,2837,443,8558,1869,6689,31,236,14,17
51769,17,0,0,60,60,0,1,0,1,0
58992,53,0,0,273,86,187,2,30,1,1
64054,53,34990,53,183,94,89,2,30,1,1
50052,65008,0,0,60,60,0,1,0,1,0
49849,53,37502,53,196,102,94,2,31,1,1
53103,8497,0,0,148,148,0,1,0,1,0
58638,5900,0,0,62,62,0,1,0,1,0
59435,445,0,0,70,70,0,1,0,1,0
61422,443,38584,443,8360,1781,6579,23,77,12,11
0,0,0,0,480,244,236,4,0,2,2
57415,445,0,0,70,70,0,1,0,1,0
27005,27027,32399,27027,880,126,754,2,31,1,1
51743,40358,22101,40358,136,136,0,3,14,3,0
37606,443,47206,443,6277,1868,4409,22,45,13,9
64144,53,47875,53,193,102,91,2,30,1,1
55939,53,43027,53,193,102,91,2,30,1,1
27005,23333,41916,23333,890,126,764,3,32,2,1
49687,53,40743,53,184,102,82,2,30,1,1
49488,443,58643,443,90030,13137,76893,92,47,29,63
61492,80,29860,80,901,398,503,10,15,5,5
58638,5900,0,0,62,62,0,1,0,1,0
65010,53,7971,53,758,102,656,2,29,1,1
58727,445,0,0,70,70,0,1,0,1,0
56635,443,56247,443,8654,2150,6504,20,15,11,9
57054,53,38199,53,164,78,86,2,30,1,1
50193,443,31534,443,2404,1121,1283,14,115,7,7
60485,22114,0,0,66,66,0,1,0,1,0
55538,53,6885,53,168,86,82,2,30,1,1
37912,443,38909,443,2738,1475,1263,19,275,10,9
58108,445,0,0,70,70,0,1,0,1,0
55932,53,22197,53,209,110,99,2,30,1,1
54760,445,0,0,70,70,0,1,0,1,0
62213,445,0,0,70,70,0,1,0,1,0
55922,53,5571,53,807,94,713,2,29,1,1
55370,445,0,0,66,66,0,1,0,1,0
44847,23628,55980,23628,509,150,359,2,1200,1,1
52881,445,0,0,70,70,0,1,0,1,0
51519,443,51519,443,8680,2323,6357,31,173,13,18
63772,35440,0,0,66,66,0,1,0,1,0
64942,53,24439,53,522,190,332,5,48,3,2
53294,445,0,0,66,66,0,1,0,1,0
50212,1688,56560,1688,70,70,0,2,8,2,0
64004,48339,32132,48339,70,70,0,1,4,1,0
51015,64147,0,0,62,62,0,1,0,1,0
63532,445,0,0,70,70,0,1,0,1,0
50575,53,5901,53,766,102,664,2,30,1,1
5588,5588,0,0,3562,1936,1626,48,196,24,24
55141,445,0,0,70,70,0,1,0,1,0
2079,7000,2079,7000,3102,1551,1551,16,16,8,8
54930,445,0,0,70,70,0,1,0,1,0
60243,445,0,0,70,70,0,1,0,1,0
51745,30188,0,0,62,62,0,1,0,1,0
18203,23,0,0,60,60,0,1,0,1,0
51134,445,0,0,66,66,0,1,0,1,0
49960,80,58313,80,9718,819,8899,19,15,9,10
26385,53,26385,53,235,90,145,2,33,1,1
39895,443,43258,443,10727,3308,7419,33,503,15,18
61583,64147,0,0,66,66,0,1,0,1,0
58970,443,57205,443,3715,1958,1757,23,21,12,11
15875,50584,0,0,62,62,0,1,0,1,0
56799,80,63768,80,1514,481,1033,11,15,6,5
50566,443,50394,443,11116,4583,6533,39,256,19,20
5661,37965,0,0,62,62,0,1,0,1,0
56882,53,12251,53,87,87,0,2,60,2,0
57470,60080,37928,60080,12668,8506,4162,117,3745,74,43
49310,53,37425,53,239,102,137,2,30,1,1
51365,445,0,0,66,66,0,1,0,1,0
59181,53,28620,53,260,86,174,2,29,1,1
50500,80,1291,80,318,192,126,6,25,4,2
55631,16191,24420,16191,504,318,186,8,16,5,3
56751,53,17361,53,752,93,659,2,30,1,1
49405,53,14474,53,94,94,0,1,30,1,0
65219,443,28202,443,4748,2193,2555,14,135,7,7
63421,44847,0,0,66,66,0,1,0,1,0
57181,53,65198,53,733,93,640,2,31,1,1
59407,445,0,0,70,70,0,1,0,1,0
55039,443,11955,443,62,62,0,1,4,1,0
65029,445,0,0,70,70,0,1,0,1,0
53896,48027,7654,48027,70,70,0,2,8,2,0
29742,50584,0,0,146,146,0,1,0,1,0
57711,445,0,0,70,70,0,1,0,1,0
57470,52215,48091,52215,528,528,0,9,1200,9,0
49967,53,41633,53,186,95,91,2,31,1,1
60239,53,53135,53,219,102,117,2,30,1,1
58638,5900,0,0,62,62,0,1,0,1,0
50749,443,31608,443,70,70,0,2,171,2,0
31235,22114,0,0,62,62,0,1,0,1,0
59696,57470,0,0,62,62,0,1,0,1,0
56343,53,26376,53,194,102,92,2,29,1,1
55221,445,0,0,70,70,0,1,0,1,0
1865,25174,0,0,146,146,0,1,0,1,0
59241,62413,0,0,62,62,0,1,0,1,0
9145,80,20559,80,318,192,126,6,30,4,2
49506,53,26702,53,200,102,98,2,31,1,1
45941,23386,0,0,60,60,0,1,0,1,0
51767,445,0,0,70,70,0,1,0,1,0
59315,445,0,0,70,70,0,1,0,1,0
55746,53,40664,53,216,110,106,2,30,1,1
49171,443,1136,443,15437,8368,7069,40,361,19,21
53497,443,53212,443,17187157,553524,16633633,18453,352,6098,12355
55429,443,25959,443,6292,4834,1458,18,129,11,7
56036,53,20624,53,762,98,664,2,31,1,1
16223,443,54966,443,7461,1034,6427,21,16,11,10
51993,25174,0,0,66,66,0,1,0,1,0
53563,35440,0,0,66,66,0,1,0,1,0
51824,80,16784,80,15487,8701,6786,29,44,17,12
42995,26467,0,0,62,62,0,1,0,1,0
60559,445,0,0,70,70,0,1,0,1,0
53687,19010,53687,19010,64,64,0,1,31,1,0
56395,445,0,0,66,66,0,1,0,1,0
50303,445,0,0,66,66,0,1,0,1,0
65029,53,39227,53,214,102,112,2,29,1,1
56608,443,64637,443,8034,2014,6020,20,15,11,9
63848,48560,48756,48560,66,66,0,2,7,2,0
59481,41182,0,0,62,62,0,1,0,1,0
57653,445,0,0,70,70,0,1,0,1,0
56939,80,26245,80,194,128,66,4,31,3,1
61150,11392,0,0,62,62,0,1,0,1,0
49676,53,32954,53,197,102,95,2,30,1,1
56323,53,5698,53,152,78,74,2,30,1,1
50309,445,0,0,70,70,0,1,0,1,0
63981,445,0,0,70,70,0,1,0,1,0
38576,443,42458,443,10853,8227,2626,30,360,15,15
64266,445,0,0,70,70,0,1,0,1,0
26690,53,55791,53,197,94,103,2,29,1,1
56636,53,8907,53,168,86,82,2,30,1,1
59107,25174,0,0,66,66,0,1,0,1,0
49633,445,0,0,70,70,0,1,0,1,0
49282,53,14515,53,178,94,84,2,30,1,1
50901,26467,0,0,66,66,0,1,0,1,0
63922,32305,41561,32305,312,132,180,6,6,3,3
55232,445,0,0,70,70,0,1,0,1,0
56770,52920,52041,52920,70,70,0,2,8,2,0
54630,53,54630,53,825,99,726,2,30,1,1
27005,27015,44800,27015,858,126,732,2,30,1,1
1040,37965,0,0,62,62,0,1,0,1,0
57332,443,64135,443,2687,1728,959,23,15,12,11
50478,80,37121,80,2869,1173,1696,11,21,6,5
57946,443,19612,443,2791,1800,991,26,185,15,11
61737,445,0,0,70,70,0,1,0,1,0
5643,53,5643,53,237,91,146,2,33,1,1
58892,443,12440,443,5167,700,4467,16,15,7,9
49872,443,65245,443,3120,1862,1258,18,15,11,7
8878,80,27996,80,1220,403,817,15,414,4,11
10016,443,37717,443,6575,1263,5312,22,315,12,10
50823,443,51509,443,6601,1120,5481,17,115,9,8
57452,443,52384,443,6990,2193,4797,15,120,7,8
58248,50584,0,0,66,66,0,1,0,1,0
50447,443,44649,443,12362,3372,8990,34,143,18,16
56491,445,0,0,70,70,0,1,0,1,0
35412,443,65351,443,1251,749,502,11,68,6,5
60434,11339,17493,11339,70,70,0,1,5,1,0
52459,33899,52459,33899,66,66,0,1,5,1,0
443,62451,0,0,199,199,0,1,0,1,0
44691,53,43758,53,199,94,105,2,30,1,1
53165,443,14639,443,7434,1695,5739,23,27,12,11
43671,37965,0,0,62,62,0,1,0,1,0
52130,1035,4806,1035,70,70,0,2,8,2,0
52210,443,33908,443,6294,1716,4578,27,23,16,11
51443,445,0,0,66,66,0,1,0,1,0
52090,80,61372,80,2774,703,2071,12,22,7,5
60155,23718,0,0,66,66,0,1,0,1,0
63852,445,0,0,66,66,0,1,0,1,0
53408,445,0,0,70,70,0,1,0,1,0
47748,161,0,0,6387,2535,3852,22,30,11,11
51719,13715,5835,13715,70,70,0,2,8,2,0
65384,443,21164,443,8613,1465,7148,22,15,13,9
60900,445,0,0,70,70,0,1,0,1,0
55912,53,61558,53,184,94,90,2,30,1,1
49470,443,50216,443,2772,1777,995,16,124,9,7
58195,38303,0,0,66,66,0,1,0,1,0
49534,53,11716,53,193,102,91,2,31,1,1
53794,445,0,0,70,70,0,1,0,1,0
27005,27018,44540,27018,882,126,756,2,30,1,1
49696,443,61815,443,42348,4871,37477,71,150,40,31
50334,53,27323,53,216,110,106,2,29,1,1
49364,53,13056,53,307,307,0,4,60,4,0
55725,445,0,0,70,70,0,1,0,1,0
50840,443,34565,443,8057,1135,6922,19,139,9,10
55984,53,2333,53,216,102,114,2,30,1,1
17344,62413,0,0,66,66,0,1,0,1,0
55770,53,22601,53,177,94,83,2,30,1,1
48347,443,29830,443,8415,883,7532,23,54,8,15
54717,445,0,0,66,66,0,1,0,1,0
2427,25174,0,0,146,146,0,1,0,1,0
50448,443,40818,443,1119,595,524,12,26,6,6
44318,51180,0,0,74,74,0,1,0,1,0
49235,53,6024,53,164,86,78,2,31,1,1
4111,25174,0,0,146,146,0,1,0,1,0
56014,443,56014,443,4334,1427,2907,19,30,11,8
50280,53,20623,53,916,86,830,2,31,1,1
55439,53,11568,53,177,94,83,2,30,1,1
51814,443,41543,443,6133,1655,4478,12,120,5,7
48155,443,36559,443,7395,1514,5881,26,225,11,15
51071,445,0,0,66,66,0,1,0,1,0
59772,62413,0,0,66,66,0,1,0,1,0
49772,53,54364,53,181,94,87,2,31,1,1
49754,443,12620,443,17243,5482,11761,82,316,41,41
65064,30188,0,0,66,66,0,1,0,1,0
64877,53,58345,53,182,93,89,2,30,1,1
38118,443,33958,443,574857,27894,546963,745,57,346,399
9234,80,38036,80,318,192,126,6,26,4,2
58646,44847,0,0,66,66,0,1,0,1,0
14567,37965,0,0,62,62,0,1,0,1,0
58876,443,42159,443,19357,12948,6409,47,18,26,21
58362,53,30634,53,167,78,89,2,30,1,1
6666,8888,0,0,60,60,0,1,0,1,0
43206,443,34471,443,4550611,95139,4455472,4046,217,935,3111
33582,44847,0,0,66,66,0,1,0,1,0
55760,443,34599,443,4344,2974,1370,22,94,12,10
5232,46495,40739,46495,832,832,0,14,96,14,0
44258,25,0,0,74,74,0,1,0,1,0
443,20995,0,0,83,83,0,1,0,1,0
55286,37965,0,0,66,66,0,1,0,1,0
55127,445,0,0,70,70,0,1,0,1,0
52815,80,10358,80,1152,712,440,10,15,5,5
51674,51505,0,0,66,66,0,1,0,1,0
18577,25174,0,0,62,62,0,1,0,1,0
64688,445,0,0,70,70,0,1,0,1,0
8890,443,57332,443,4367,1108,3259,37,426,11,26
34166,22114,0,0,62,62,0,1,0,1,0
51438,443,45079,443,42419,28515,13904,108,246,53,55
54661,445,0,0,70,70,0,1,0,1,0
49812,53,36103,53,1411,98,1313,4,52,2,2
59497,64097,0,0,66,66,0,1,0,1,0
51363,445,0,0,70,70,0,1,0,1,0
58638,5900,0,0,62,62,0,1,0,1,0
54112,445,0,0,70,70,0,1,0,1,0
49800,53,22865,53,182,93,89,2,31,1,1
38848,80,21726,80,288702,9850,278852,312,105,123,189
62107,445,0,0,70,70,0,1,0,1,0
56465,443,52483,443,6081,844,5237,17,15,9,8
49752,50584,0,0,62,62,0,1,0,1,0
50178,53,23159,53,758,96,662,2,31,1,1
56432,53,16819,53,195,102,93,2,30,1,1
58707,80,41124,80,2542,1879,663,12,14,6,6
16387,7205,0,0,60,60,0,1,0,1,0
58638,5900,0,0,62,62,0,1,0,1,0
2541,51505,0,0,66,66,0,1,0,1,0
65196,53,58386,53,177,94,83,2,30,1,1
53447,80,56181,80,1517,481,1036,11,15,6,5
3559,51050,0,0,146,146,0,1,0,1,0
52612,445,0,0,70,70,0,1,0,1,0
62085,445,0,0,70,70,0,1,0,1,0
64762,53,32990,53,188,96,92,2,30,1,1
55056,56205,0,0,66,66,0,1,0,1,0
33229,443,52661,443,2161,1231,930,17,180,9,8
10533,23,0,0,60,60,0,1,0,1,0
56498,53,39557,53,199,102,97,2,30,1,1
50517,80,5050,80,502,256,246,9,25,5,4
32484,2323,0,0,60,60,0,1,0,1,0
8916,443,25420,443,7685,1016,6669,29,413,11,18
50759,443,24454,443,19782,3596,16186,38,256,21,17
56304,53,19681,53,184,94,90,2,30,1,1
49874,443,49241,443,15358,8278,7080,47,19,24,23
57235,443,36461,443,8954,3404,5550,34,46,19,15
61002,37965,0,0,145,145,0,1,0,1,0
1926,53,62848,53,210,78,132,2,30,1,1
50143,35253,0,0,62,62,0,1,0,1,0
50265,41071,33048,41071,1716,1716,0,27,2188,27,0
55141,53,13525,53,184,94,90,2,31,1,1
50847,445,0,0,70,70,0,1,0,1,0
53114,32975,31768,32975,70,70,0,2,8,2,0
59750,53,24886,53,304,86,218,2,29,1,1
52838,53,22296,53,168,78,90,2,30,1,1
26494,26467,0,0,62,62,0,1,0,1,0
55843,445,0,0,70,70,0,1,0,1,0
49945,53,50921,53,281,97,184,4,58,2,2
58638,5900,0,0,62,62,0,1,0,1,0
59223,17500,0,0,66,66,0,1,0,1,0
65189,28015,14178,28015,240,78,162,2,29,1,1
50375,1,0,0,74,74,0,1,91,1,0
54632,445,0,0,66,66,0,1,0,1,0
37272,443,58616,443,10809,2465,8344,45,121,21,24
56624,443,46421,443,12807,129,12678,13,147,2,11
46715,443,4396,443,2945,779,2166,10,121,5,5
64909,445,0,0,70,70,0,1,0,1,0
50280,53,42526,53,794,102,692,2,30,1,1
65442,443,8292,443,3783,1087,2696,11,120,5,6
53070,53,0,0,168,74,94,2,29,1,1
49388,53,27609,53,215,102,113,2,30,1,1
64560,53,23612,53,802,104,698,2,30,1,1
49633,80,21073,80,318,192,126,6,41,4,2
55029,443,56750,443,35270,2782,32488,48,51,22,26
56703,53,53438,53,199,102,97,2,30,1,1
64528,53,42814,53,353,118,235,2,30,1,1
49514,65504,0,0,162,162,0,1,0,1,0
50075,443,63297,443,4701,2758,1943,41,93,22,19
34760,443,55387,443,70,70,0,1,4,1,0
62215,445,0,0,70,70,0,1,0,1,0
23031,22114,0,0,146,146,0,1,0,1,0
58836,51505,0,0,66,66,0,1,0,1,0
51909,6881,0,0,66,66,0,1,0,1,0
64201,53,27931,53,200,94,106,2,29,1,1
57543,445,0,0,70,70,0,1,0,1,0
56925,53,48692,53,196,102,94,2,30,1,1
50326,443,7479,443,7819,2474,5345,25,82,13,12
58841,443,62984,443,5168,700,4468,16,15,7,9
26872,44847,0,0,62,62,0,1,0,1,0
57590,443,26107,443,2614,1689,925,18,19,10,8
56829,33418,63291,33418,316,136,180,6,5,3,3
51840,34678,44195,34678,70,70,0,1,5,1,0
55223,443,2473,443,1118883,33814,1085069,1206,48,451,755
45941,23388,0,0,60,60,0,1,0,1,0
50116,22,50116,22,184,120,64,4,11,3,1
20689,53,20689,53,237,91,146,2,33,1,1
56276,443,43498,443,71414,17145,54269,194,292,91,103
64619,53,61367,53,438,89,349,4,44,2,2
64998,53,50318,53,214,94,120,2,30,1,1
49343,53,20254,53,478,106,372,4,48,2,2
52235,48910,47820,48910,136,136,0,3,14,3,0
44894,443,39327,443,1849,1130,719,17,36,9,8
60984,445,0,0,70,70,0,1,0,1,0
443,39711,0,0,74,74,0,1,0,1,0
11601,53,11601,53,233,91,142,2,31,1,1
58842,445,0,0,70,70,0,1,0,1,0
55273,53,29396,53,167,86,81,2,30,1,1
57470,50321,60490,50321,5231,5231,0,79,5173,79,0
47910,7464,0,0,60,60,0,1,0,1,0
17171,22114,0,0,66,66,0,1,0,1,0
51602,22114,0,0,66,66,0,1,0,1,0
50822,445,0,0,70,70,0,1,0,1,0
51797,80,10283,80,9897,4338,5559,27,58,16,11
56426,53,49161,53,184,94,90,2,30,1,1
52575,22114,0,0,66,66,0,1,0,1,0
50341,5222,19733,5222,9254,3356,5898,74,444,30,44
29577,64147,0,0,62,62,0,1,0,1,0
49654,53,49736,53,184,94,90,2,30,1,1
65275,53,62237,53,184,94,90,2,30,1,1
12951,50584,0,0,66,66,0,1,0,1,0
52795,445,0,0,66,66,0,1,0,1,0
51007,445,0,0,70,70,0,1,0,1,0
45941,23386,0,0,60,60,0,1,0,1,0
65515,53,3298,53,210,110,100,2,30,1,1
65006,53,44331,53,763,102,661,2,30,1,1
5610,37965,0,0,66,66,0,1,0,1,0
49570,443,32958,443,6360,2483,3877,20,16,10,10
60384,64147,0,0,62,62,0,1,0,1,0
53737,51456,15956,51456,70,70,0,2,8,2,0
50274,445,0,0,66,66,0,1,0,1,0
32609,64097,0,0,66,66,0,1,0,1,0
58574,445,0,0,70,70,0,1,0,1,0
61314,23,0,0,60,60,0,1,0,1,0
46556,443,5923,443,9316,1720,7596,25,16,13,12
63943,53,51755,53,274,90,184,4,56,2,2
35610,37965,0,0,62,62,0,1,0,1,0
49196,53,18490,53,230,91,139,3,47,2,1
51237,443,50232,443,9668,4698,4970,42,16,25,17
55868,53,41641,53,177,94,83,2,29,1,1
42044,60043,0,0,66,66,0,1,0,1,0
58305,51180,0,0,66,66,0,1,0,1,0
57863,443,52780,443,1981,1155,826,19,86,10,9
39325,443,37130,443,1396,735,661,14,80,8,6
61605,445,0,0,70,70,0,1,0,1,0
65048,53,26939,53,188,96,92,2,31,1,1
56427,53,25251,53,178,94,84,2,29,1,1
50156,53,6756,53,186,102,84,2,30,1,1
48817,49490,48817,49490,513,152,361,2,1200,1,1
65057,53,5504,53,199,102,97,2,30,1,1
54992,443,45267,443,31183,3879,27304,52,19,26,26
43923,5222,15090,5222,3007,1354,1653,28,83,15,13
16403,16384,8455,16384,426,186,240,8,30,4,4
59282,443,30587,443,5413,968,4445,20,15,11,9
42184,53,42184,53,334,226,108,3,30,2,1
64828,53,62244,53,260,102,158,2,30,1,1
49792,443,3776,443,6089,799,5290,16,126,8,8
43552,443,10231,443,4680,2873,1807,26,53,15,11
55052,80,37545,80,11677266,314362,11362904,12711,129,5174,7537
21034,50265,0,0,66,66,0,1,0,1,0
52185,445,0,0,70,70,0,1,0,1,0
62769,25174,0,0,146,146,0,1,0,1,0
28012,443,23129,443,6388,1112,5276,18,75,9,9
58874,443,39745,443,21478,2212,19266,47,86,19,28
53015,64147,0,0,62,62,0,1,0,1,0
60575,80,18847,80,9034,1860,7174,17,16,8,9
49677,64147,0,0,62,62,0,1,0,1,0
49705,445,0,0,70,70,0,1,0,1,0
59947,445,0,0,70,70,0,1,0,1,0
49160,6886,47580,6886,854,150,704,4,1200,2,2
58938,445,0,0,70,70,0,1,0,1,0
63945,28291,25473,28291,504,382,122,8,15,6,2
57344,53,44764,53,228,110,118,2,30,1,1
51769,51505,0,0,62,62,0,1,0,1,0
59896,443,22952,443,1537,934,603,14,32,7,7
61484,445,0,0,70,70,0,1,0,1,0
64666,53,52653,53,226,102,124,2,30,1,1
51174,445,0,0,70,70,0,1,0,1,0
49166,53,17612,53,322,102,220,2,30,1,1
44127,30188,0,0,146,146,0,1,0,1,0
57849,50584,0,0,66,66,0,1,0,1,0
56818,53,44106,53,755,94,661,2,30,1,1
27005,33111,35417,33111,895,126,769,2,31,1,1
35207,22114,0,0,146,146,0,1,0,1,0
16387,3655,0,0,60,60,0,1,0,1,0
54442,445,0,0,70,70,0,1,0,1,0
60888,443,18783,443,7454,3131,4323,23,46,13,10
53252,445,0,0,66,66,0,1,0,1,0
60312,57470,0,0,74,74,0,1,0,1,0
52957,53,50377,53,168,78,90,2,29,1,1
56919,445,0,0,70,70,0,1,0,1,0
26884,57866,0,0,74,74,0,1,0,1,0
56739,53,42182,53,195,102,93,2,30,1,1
65099,53,58455,53,199,102,97,2,30,1,1
65117,53,1871,53,198,102,96,2,30,1,1
58391,443,1299,443,347192,61325,285867,643,191,297,346
51966,18716,18361,18716,66,66,0,1,5,1,0
56322,53,2088,53,209,110,99,2,30,1,1
51408,443,60315,443,8774,3355,5419,19,36,11,8
53265,443,57484,443,4995,1414,3581,21,15,12,9
53918,53,0,0,222,82,140,2,30,1,1
42298,40005,47580,40005,211,89,122,4,29,2,2
51152,443,11725,443,44048,4441,39607,97,317,43,54
56195,53,13348,53,194,94,100,2,30,1,1
6960,53,6960,53,186,83,103,2,30,1,1
63239,443,35910,443,5725,3290,2435,34,125,19,15
63786,35440,0,0,66,66,0,1,0,1,0
65270,3855,0,0,78,78,0,1,0,1,0
33846,443,41735,443,7760,2646,5114,24,16,13,11
56601,443,39654,443,8978,3243,5735,22,45,13,9
55724,45682,6518,45682,70,70,0,1,5,1,0
58468,37965,0,0,66,66,0,1,0,1,0
50377,445,0,0,70,70,0,1,0,1,0
49178,80,4471,80,2807,587,2220,13,16,7,6
60527,35440,0,0,66,66,0,1,0,1,0
63326,445,0,0,70,70,0,1,0,1,0
49672,53,36807,53,718,94,624,2,30,1,1
30135,37965,0,0,62,62,0,1,0,1,0
53706,59208,33732,59208,258,70,188,4,8,2,2
52741,24211,0,0,66,66,0,1,0,1,0
56062,445,0,0,66,66,0,1,0,1,0
51999,37965,0,0,62,62,0,1,0,1,0
55999,53,41388,53,774,101,673,2,30,1,1
59084,443,59084,443,4598,1691,2907,19,30,11,8
49352,443,43143,443,2118582,46411,2072171,2066,90,617,1449
64277,53,1694,53,337,110,227,2,30,1,1
49378,53,56071,53,268,94,174,2,30,1,1
65439,53,10579,53,228,110,118,2,30,1,1
35812,1,0,0,146,146,0,1,0,1,0
443,63113,0,0,100,100,0,1,0,1,0
50652,445,0,0,66,66,0,1,0,1,0
64649,53,32892,53,807,94,713,2,30,1,1
54220,445,0,0,70,70,0,1,0,1,0
63379,36237,0,0,62,62,0,1,0,1,0
49727,443,37710,443,5037,1135,3902,16,18,9,7
50673,80,12286,80,20265,5748,14517,34,23,16,18
43531,53,58732,53,199,94,105,2,30,1,1
49418,27017,22257,27017,271,78,193,2,31,1,1
52021,80,35964,80,422,240,182,8,25,5,3
52119,49239,18789,49239,258,70,188,4,8,2,2
56864,53,5721,53,200,102,98,2,30,1,1
64975,27033,50776,27033,734,462,272,2,30,1,1
51921,443,16602,443,7970,4154,3816,39,102,23,16
5685,35440,0,0,66,66,0,1,0,1,0
19116,53,19116,53,398,255,143,3,33,2,1
59845,44847,0,0,66,66,0,1,0,1,0
19371,53,19371,53,214,82,132,2,31,1,1
60345,80,36242,80,2124,1158,966,13,87,7,6
64719,53,54824,53,196,102,94,2,30,1,1
65060,35440,0,0,66,66,0,1,0,1,0
25772,7302,0,0,62,62,0,1,0,1,0
51744,445,0,0,70,70,0,1,0,1,0
54398,445,0,0,66,66,0,1,0,1,0
63869,34368,47992,34368,66,66,0,2,8,2,0
53640,25174,0,0,66,66,0,1,0,1,0
54423,445,0,0,70,70,0,1,0,1,0
49234,445,0,0,70,70,0,1,0,1,0
50473,80,50473,80,78355,11395,66960,122,27,62,60
54961,53,50012,53,211,102,109,2,29,1,1
49841,53,53641,53,751,95,656,2,30,1,1
50305,53,38735,53,209,110,99,2,30,1,1
49418,27015,40733,27015,242,78,164,2,30,1,1
50395,80,11837,80,487,180,307,6,26,4,2
58962,80,58962,80,22844,1529,21315,39,28,20,19
50265,18417,40558,18417,7282,4118,3164,57,1696,35,22
49636,53,23682,53,180,94,86,2,30,1,1
41459,80,32156,80,1866,1032,834,11,150,6,5
65487,53,58054,53,184,94,90,2,29,1,1
54966,53,59029,53,255,88,167,4,32,2,2
55679,1024,62004,1024,70,70,0,1,5,1,0
55698,45710,57579,45710,70,70,0,1,5,1,0
64744,445,0,0,70,70,0,1,0,1,0
54446,445,0,0,66,66,0,1,0,1,0
49512,53,64595,53,210,102,108,2,30,1,1
38475,11392,0,0,66,66,0,1,0,1,0
55692,443,55692,443,7516,1498,6018,25,79,11,14
22439,25174,0,0,66,66,0,1,0,1,0
65166,62413,0,0,62,62,0,1,0,1,0
49776,53,42364,53,182,94,88,2,30,1,1
55896,53,48962,53,168,86,82,2,30,1,1
60769,443,35964,443,3758,1691,2067,12,135,6,6
57103,53,56809,53,193,102,91,2,30,1,1
53540,34134,43313,34134,70,70,0,2,7,2,0
34897,50584,0,0,62,62,0,1,0,1,0
53845,445,0,0,70,70,0,1,0,1,0
64482,53,47729,53,196,102,94,2,30,1,1
5686,80,5686,80,326,186,140,6,29,4,2
3478,61463,0,0,877,877,0,1,0,1,0
60413,80,20847,80,958,543,415,11,315,6,5
53227,443,46822,443,5430,687,4743,15,73,6,9
35460,35440,0,0,62,62,0,1,0,1,0
60627,51050,0,0,62,62,0,1,0,1,0
49320,53,59903,53,177,94,83,2,30,1,1
56109,53,22951,53,177,94,83,2,30,1,1
42252,33303,0,0,60,60,0,1,0,1,0
58294,443,58294,443,7356,1014,6342,20,76,10,10
6881,5903,6718,5903,501,150,351,2,1200,1,1
59287,445,0,0,70,70,0,1,0,1,0
2531,30188,0,0,62,62,0,1,0,1,0
7310,44847,0,0,66,66,0,1,0,1,0
56358,53,65243,53,210,110,100,2,33,1,1
63237,445,0,0,70,70,0,1,0,1,0
64113,53,33491,53,294,134,160,2,30,1,1
64024,57825,29804,57825,312,132,180,6,6,3,3
57669,445,0,0,70,70,0,1,0,1,0
54535,80,13360,80,4162,3455,707,14,15,8,6
57013,80,43644,80,5696,703,4993,14,75,8,6
55053,443,38835,443,23234,3906,19328,40,61,19,21
9957,32480,0,0,66,66,0,1,0,1,0
40207,80,3053,80,1364,860,504,13,32,8,5
43078,80,13694,80,1052,612,440,10,15,5,5
44974,443,22658,443,17760,13913,3847,54,167,25,29
52050,445,0,0,66,66,0,1,0,1,0
64573,445,0,0,70,70,0,1,0,1,0
50116,80,62862,80,10094,1100,8994,20,33,10,10
58638,5900,0,0,62,62,0,1,0,1,0
55618,45341,56428,45341,70,70,0,1,5,1,0
50878,80,60118,80,325925,18062,307863,377,146,161,216
38019,443,55149,443,884,464,420,13,28,7,6
58638,5900,58638,5900,156,62,94,2,10,1,1
63895,44847,0,0,62,62,0,1,0,1,0
55159,53,17196,53,168,86,82,2,30,1,1
46180,1433,0,0,60,60,0,1,0,1,0
65463,53,50986,53,177,94,83,2,30,1,1
61961,11392,0,0,66,66,0,1,0,1,0
49315,443,55462,443,160961,7302,153659,171,87,49,122
48941,443,53829,443,10085,3487,6598,21,120,9,12
53243,57470,0,0,74,74,0,1,0,1,0
52763,53,0,0,641,87,554,2,30,1,1
37893,53,0,0,86,86,0,1,30,1,0
34879,443,57316,443,167,107,60,2,5,1,1
41184,53,29887,53,168,78,90,2,30,1,1
51580,80,9107,80,1752,786,966,16,17,9,7
12531,22114,0,0,62,62,0,1,0,1,0
61688,445,0,0,70,70,0,1,0,1,0
56424,53,14436,53,306,94,212,2,30,1,1
54652,53,54652,53,216,98,118,2,30,1,1
8080,37965,0,0,62,62,0,1,0,1,0
50584,16453,1503,16453,161,161,0,2,1200,2,0
52626,44847,0,0,62,62,0,1,0,1,0
52225,31985,22878,31985,70,70,0,2,8,2,0
54961,443,58980,443,1015861,30762,985099,1147,257,421,726
57228,8525,57228,8525,138,78,60,2,5,1,1
59448,445,0,0,70,70,0,1,0,1,0
30960,45723,17261,45723,330,330,0,6,3608,6,0
60957,443,56619,443,68539,4175,64364,98,32,46,52
23197,44847,0,0,62,62,0,1,0,1,0
56375,53,25593,53,216,110,106,2,30,1,1
62598,445,0,0,66,66,0,1,0,1,0
51505,17372,0,0,62,62,0,1,0,1,0
53585,445,0,0,66,66,0,1,0,1,0
49880,443,51797,443,1087632,32231,1055401,1112,53,334,778
59399,443,48462,443,66108,6145,59963,93,16,41,52
56413,51221,0,0,62,62,0,1,0,1,0
40204,40026,38971,40026,148,86,62,2,30,1,1
58638,5900,0,0,62,62,0,1,0,1,0
57061,53,24920,53,197,94,103,2,29,1,1
50207,53,4187,53,195,102,93,2,29,1,1
58638,5900,0,0,62,62,0,1,0,1,0
49787,53,40556,53,258,110,148,2,29,1,1
56889,53,22522,53,211,110,101,2,30,1,1
53089,24211,0,0,66,66,0,1,0,1,0
27005,1301,24545,1301,860,126,734,2,30,1,1
50002,443,45848,443,25358,6778,18580,31,16,13,18
51919,80,35345,80,16004,8270,7734,32,57,17,15
52116,64692,3805,64692,70,70,0,1,5,1,0
58213,37807,0,0,66,66,0,1,0,1,0
56804,445,0,0,70,70,0,1,0,1,0
39416,443,35535,443,32732,6260,26472,69,217,34,35
56788,53,30869,53,199,102,97,2,30,1,1
49865,443,1213,443,8535,1936,6599,22,87,12,10
55427,53,28517,53,772,103,669,2,30,1,1
23512,57354,0,0,145,145,0,1,0,1,0
15959,56205,0,0,66,66,0,1,0,1,0
20345,57470,0,0,146,146,0,1,0,1,0
27005,27015,20017,27015,882,126,756,2,30,1,1
49849,443,49569,443,6117,976,5141,21,72,10,11
34811,56205,0,0,66,66,0,1,0,1,0
2828,35253,0,0,66,66,0,1,0,1,0
64616,53,29802,53,184,80,104,2,30,1,1
58785,53,54759,53,211,86,125,2,30,1,1
64601,445,0,0,66,66,0,1,0,1,0
50327,1433,0,0,60,60,0,1,0,1,0
65040,53,27133,53,256,88,168,4,32,2,2
49160,6889,59737,6889,834,150,684,4,1200,2,2
50585,443,60446,443,1594,951,643,15,97,8,7
55681,53,52185,53,711,87,624,2,30,1,1
55114,445,0,0,66,66,0,1,0,1,0
56440,80,38855,80,17008,1379,15629,22,25,7,15
52769,51221,0,0,62,62,0,1,0,1,0
56955,53,20294,53,184,86,98,2,29,1,1
46674,53,59897,53,168,78,90,2,30,1,1
56046,53,55070,53,193,102,91,2,31,1,1
34378,443,1903,443,11269403,319214,10950189,11392,382,3773,7619
27005,28215,29356,28215,879,126,753,2,30,1,1
60454,18359,20909,18359,1842,1017,825,19,16,9,10
56925,53,26704,53,275,110,165,2,29,1,1
50601,80,50601,80,4206,3273,933,17,19,9,8
59744,80,14710,80,699554,16426,683128,701,95,244,457
64216,445,0,0,66,66,0,1,0,1,0
44208,26467,0,0,62,62,0,1,0,1,0
55216,445,0,0,70,70,0,1,0,1,0
44062,443,52650,443,8998,1684,7314,24,170,12,12
56563,443,19548,443,4528,884,3644,15,26,9,6
7356,25174,0,0,66,66,0,1,0,1,0
49978,53,13448,53,190,97,93,2,30,1,1
443,20995,0,0,83,83,0,1,0,1,0
52907,445,0,0,70,70,0,1,0,1,0
60421,6882,64164,6882,70,70,0,2,8,2,0
49737,443,51096,443,334252,14917,319335,405,73,179,226
56805,53,61616,53,178,94,84,2,31,1,1
57028,8080,10225,8080,78,78,0,2,8,2,0
56381,25174,0,0,62,62,0,1,0,1,0
27005,27001,28063,27001,887,126,761,2,31,1,1
55379,445,0,0,70,70,0,1,0,1,0
56318,53,8880,53,182,93,89,2,31,1,1
42309,443,23092,443,7295,1469,5826,30,360,9,21
53027,445,0,0,70,70,0,1,0,1,0
34458,80,25271,80,6260,696,5564,17,16,9,8
47787,53,24914,53,198,93,105,2,31,1,1
11136,15503,0,0,62,62,0,1,0,1,0
58638,5900,0,0,62,62,0,1,0,1,0
50328,53,20316,53,783,96,687,2,30,1,1
57730,445,0,0,66,66,0,1,0,1,0
30296,53,30296,53,233,90,143,2,33,1,1
32520,50265,0,0,145,145,0,1,0,1,0
49556,53,1572,53,300,100,200,4,43,2,2
51966,25174,0,0,62,62,0,1,0,1,0
57990,445,0,0,70,70,0,1,0,1,0
49686,445,0,0,70,70,0,1,0,1,0
56127,35440,0,0,62,62,0,1,0,1,0
51102,443,51987,443,13990,9102,4888,28,15,16,12
64840,53,31006,53,186,95,91,2,31,1,1
43108,443,38121,443,7578,2358,5220,18,121,8,10
56704,53,8695,53,194,102,92,2,31,1,1
55475,53,3330,53,381,102,279,4,44,2,2
50820,80,16954,80,550,476,74,6,15,5,1
39718,443,11292,443,10186,3128,7058,26,16,13,13
50048,80,54605,80,2140,1030,1110,22,149,8,14
64580,53,58707,53,425,90,335,4,43,2,2
49218,445,0,0,70,70,0,1,0,1,0
56765,1841,2876,1841,70,70,0,1,5,1,0
61798,35440,0,0,66,66,0,1,0,1,0
50164,445,0,0,66,66,0,1,0,1,0
41632,443,12669,443,7670,2131,5539,30,27,15,15
49621,53,49621,53,231,90,141,2,31,1,1
49757,53,24825,53,212,94,118,2,29,1,1
13911,57470,0,0,60,60,0,1,0,1,0
38402,443,34859,443,8119,1962,6157,24,360,11,13
26900,27017,27524,27017,422,164,258,6,30,3,3
62717,445,0,0,66,66,0,1,0,1,0
51425,37450,0,0,66,66,0,1,0,1,0
65197,445,0,0,70,70,0,1,0,1,0
443,44683,0,0,83,83,0,1,0,1,0
56631,443,17729,443,7889,1900,5989,20,16,11,9
55195,443,24998,443,3543,1855,1688,20,122,10,10
65053,53,62092,53,197,94,103,2,30,1,1
41027,80,41027,80,18224,2763,15461,29,126,14,15
24311,22617,0,0,60,60,0,1,0,1,0
61030,53,15331,53,167,78,89,2,30,1,1
54074,443,19199,443,72465,3991,68474,98,169,43,55
60309,443,17740,443,130,70,60,3,5,2,1
56879,445,0,0,70,70,0,1,0,1,0
50351,80,28696,80,1083,653,430,8,15,5,3
49478,53,25544,53,172,94,78,2,30,1,1
55002,445,0,0,70,70,0,1,0,1,0
37965,30982,7359,30982,528,528,0,9,1199,9,0
65487,53,21256,53,184,94,90,2,30,1,1
38863,443,38863,443,36313,5931,30382,72,108,36,36
53874,445,0,0,70,70,0,1,0,1,0
27005,27015,9469,27015,887,126,761,2,30,1,1
63998,21247,0,0,66,66,0,1,0,1,0
49181,2710,53031,2710,70,70,0,2,8,2,0
2780,23117,0,0,62,62,0,1,0,1,0
53270,443,30676,443,6894,1556,5338,23,3601,13,10
65056,53,26315,53,199,102,97,2,29,1,1
56748,445,0,0,70,70,0,1,0,1,0
60002,445,0,0,66,66,0,1,0,1,0
56344,53,27123,53,198,101,97,2,31,1,1
40217,443,61607,443,5377,857,4520,21,88,8,13
60392,445,0,0,70,70,0,1,0,1,0
25523,35974,0,0,62,62,0,1,0,1,0
56791,53,43251,53,250,87,163,4,58,2,2
51444,445,0,0,66,66,0,1,0,1,0
59911,80,3482,80,2025658,45348,1980310,1992,44,640,1352
51569,445,0,0,70,70,0,1,0,1,0
54817,47993,0,0,66,66,0,1,0,1,0
58638,5900,0,0,62,62,0,1,0,1,0
63963,53,46328,53,262,86,176,4,46,2,2
64483,445,0,0,70,70,0,1,0,1,0
52563,17235,0,0,74,74,0,1,0,1,0
64956,53,29274,53,196,102,94,2,30,1,1
63785,55255,57684,55255,3706,2125,1581,18,33,10,8
64381,445,0,0,70,70,0,1,0,1,0
51050,445,0,0,66,66,0,1,0,1,0
56647,443,58814,443,1327,918,409,10,25,6,4
60311,56205,0,0,62,62,0,1,0,1,0
51987,23136,59906,23136,70,70,0,2,8,2,0
40806,443,37490,443,3287,2049,1238,12,31,7,5
65501,443,33887,443,416348,12360,403988,429,16,151,278
16454,25174,0,0,66,66,0,1,0,1,0
49346,445,0,0,70,70,0,1,0,1,0
53238,443,61389,443,13597,1371,12226,26,323,11,15
56004,53,16480,53,177,94,83,2,30,1,1
56296,53,43298,53,216,110,106,2,30,1,1
53330,445,0,0,70,70,0,1,0,1,0
65484,443,65484,443,4640,1733,2907,19,27,11,8
49210,33757,6282,33757,70,70,0,1,5,1,0
65371,445,0,0,66,66,0,1,0,1,0
443,50238,0,0,331,331,0,1,0,1,0
57760,80,57760,80,2934,1497,1437,10,16,6,4
57400,445,0,0,66,66,0,1,0,1,0
63111,445,0,0,66,66,0,1,0,1,0
59772,80,1176,80,5558,3386,2172,29,36,15,14
49812,53,11228,53,166,86,80,2,30,1,1
51658,80,26955,80,39464,2150,37314,81,20,26,55
37563,443,52126,443,499,425,74,4,0,3,1
57386,53,39494,53,193,102,91,2,30,1,1
52217,445,0,0,66,66,0,1,0,1,0
26435,39004,0,0,62,62,0,1,0,1,0
51774,80,22011,80,240,120,120,5,27,3,2
46842,25174,0,0,146,146,0,1,0,1,0
37179,443,24898,443,7440,3165,4275,31,358,17,14
64949,53,48447,53,212,110,102,2,31,1,1
37965,24475,30249,24475,480,149,331,2,1200,1,1
64817,445,0,0,70,70,0,1,0,1,0
50689,443,50217,443,152,86,66,2,4,1,1
50584,443,50316,443,36457,2308,34149,52,98,23,29
58739,445,0,0,66,66,0,1,0,1,0
49713,53,55679,53,734,94,640,2,30,1,1
64251,53,6102,53,177,94,83,2,30,1,1
56312,53,62526,53,195,102,93,2,30,1,1
51913,445,0,0,70,70,0,1,0,1,0
57419,445,0,0,66,66,0,1,0,1,0
57351,62413,0,0,66,66,0,1,0,1,0
45064,25174,0,0,62,62,0,1,0,1,0
45386,5222,47309,5222,4579,2357,2222,46,114,26,20
34932,38608,0,0,62,62,0,1,0,1,0
49543,53,24051,53,880,189,691,6,75,3,3
57217,445,0,0,66,66,0,1,0,1,0
42608,1,0,0,62,62,0,1,0,1,0
32299,40015,58130,40015,148,86,62,2,30,1,1
58939,443,28561,443,6403,4065,2338,22,16,11,11
53753,46790,44362,46790,492,306,186,8,15,5,3
55185,443,43469,443,6389,1163,5226,19,25,11,8
57416,53,62592,53,186,95,91,2,31,1,1
52211,56648,57880,56648,70,70,0,2,8,2,0
57063,53,34748,53,177,94,83,2,30,1,1
53629,443,53629,443,4620,1713,2907,19,30,11,8
58638,5900,0,0,62,62,0,1,0,1,0
56273,53,48350,53,197,102,95,2,33,1,1
57987,56125,0,0,90,90,0,1,0,1,0
52386,445,0,0,70,70,0,1,0,1,0
55021,443,3999,443,5987,1556,4431,19,47,12,7
50957,445,0,0,70,70,0,1,0,1,0
53419,445,0,0,66,66,0,1,0,1,0
49761,445,0,0,66,66,0,1,0,1,0
56997,123,16433,123,184,94,90,2,30,1,1
65422,53,8384,53,448,84,364,4,54,2,2
60171,443,39238,443,1059,556,503,12,25,6,6
50748,445,0,0,66,66,0,1,0,1,0
49923,80,28185,80,1126,609,517,11,15,6,5
52038,14487,18653,14487,70,70,0,2,7,2,0
3764,9694,0,0,66,66,0,1,0,1,0
58638,5900,0,0,62,62,0,1,0,1,0
49708,53,14475,53,185,102,83,2,30,1,1
58338,3369,0,0,60,60,0,1,0,1,0
65447,53,29961,53,330,105,225,4,37,2,2
56846,53,22209,53,196,102,94,2,31,1,1
50127,443,64951,443,31982,9936,22046,61,16,33,28
10002,40012,52638,40012,261,198,63,2,29,1,1
59493,44847,0,0,66,66,0,1,0,1,0
43701,3389,43701,3389,3910,1805,2105,20,19,12,8
58638,5900,0,0,62,62,0,1,0,1,0
56887,445,0,0,66,66,0,1,0,1,0
56744,31151,15345,31151,1703,524,1179,9,30,5,4
63259,445,0,0,70,70,0,1,0,1,0
48165,53,17622,53,199,94,105,2,30,1,1
55690,443,36462,443,914,444,470,14,29,7,7
56759,55201,4487,55201,70,70,0,2,8,2,0
34814,80,10830,80,9105,1930,7175,18,16,9,9
57073,57470,0,0,62,62,0,1,0,1,0
3407,57866,0,0,66,66,0,1,0,1,0
64600,80,64600,80,98859,6426,92433,136,27,68,68
12986,64147,0,0,62,62,0,1,0,1,0
61234,48817,0,0,106,106,0,1,0,1,0
52359,443,35892,443,13972,2550,11422,29,954,11,18
49858,80,51229,80,1539,674,865,11,89,6,5
52944,53,19420,53,168,78,90,2,30,1,1
37905,443,37905,443,4707,1800,2907,19,26,11,8
48706,23393,0,0,60,60,0,1,0,1,0
56803,53,43368,53,182,93,89,2,30,1,1
65321,53,29738,53,166,85,81,2,30,1,1
58221,445,0,0,70,70,0,1,0,1,0
55232,53,12562,53,177,94,83,2,29,1,1
1024,57470,0,0,62,62,0,1,0,1,0
50999,443,57620,443,6765,1108,5657,17,18,10,7
43916,21,0,0,60,60,0,1,0,1,0
36276,7000,36276,7000,3638,2027,1611,17,15,9,8
50263,445,0,0,70,70,0,1,0,1,0
51830,443,51830,443,17899,5015,12884,33,36,14,19
53038,445,0,0,70,70,0,1,0,1,0
52837,53,0,0,86,86,0,1,29,1,0
55024,445,0,0,70,70,0,1,0,1,0
52569,445,0,0,70,70,0,1,0,1,0
51766,48169,32212,48169,70,70,0,1,5,1,0
62658,445,0,0,70,70,0,1,0,1,0
58055,80,49869,80,254,128,126,5,15,3,2
56249,443,29498,443,80340,72269,8071,106,122,65,41
59477,36829,0,0,66,66,0,1,0,1,0
52784,443,47288,443,2802,1626,1176,18,72,9,9
51687,80,38806,80,1517,481,1036,11,15,6,5
46128,443,47204,443,9814,2331,7483,38,255,19,19
6882,51505,0,0,66,66,0,1,0,1,0
43514,443,45895,443,9643,2462,7181,26,146,11,15
54737,50584,0,0,66,66,0,1,0,1,0
55742,53,18944,53,193,102,91,2,30,1,1
53812,443,19260,443,499,425,74,4,0,3,1
55265,445,0,0,70,70,0,1,0,1,0
49388,445,0,0,70,70,0,1,0,1,0
50659,445,0,0,70,70,0,1,0,1,0
12471,31573,0,0,62,62,0,1,0,1,0
53706,80,53481,80,1398,590,808,9,111,6,3
65318,80,50736,80,2356,499,1857,10,134,6,4
58638,5900,0,0,62,62,0,1,0,1,0
15274,19473,0,0,62,62,0,1,0,1,0
49220,2710,38165,2710,70,70,0,1,5,1,0
58179,443,33593,443,7883,1768,6115,30,36,14,16
63995,53,52864,53,212,94,118,2,30,1,1
26452,80,26452,80,642,338,304,10,33,6,4
56668,53,7163,53,199,102,97,2,30,1,1
1024,64147,0,0,62,62,0,1,0,1,0
63584,443,2301,443,7146,2010,5136,34,167,18,16
60748,445,0,0,70,70,0,1,0,1,0
34441,53,34441,53,314,98,216,2,30,1,1
53852,14099,17770,14099,320,140,180,6,6,3,3
54908,445,0,0,66,66,0,1,0,1,0
55411,53,25352,53,183,94,89,2,30,1,1
53453,2767,0,0,66,66,0,1,0,1,0
49762,53,30143,53,819,102,717,2,29,1,1
54204,445,0,0,66,66,0,1,0,1,0
1025,50584,0,0,62,62,0,1,0,1,0
6580,443,39397,443,2227,1018,1209,17,16,8,9
56274,53,38501,53,177,94,83,2,30,1,1
0,0,0,0,156,156,0,2,0,2,0
49371,445,0,0,70,70,0,1,0,1,0
64146,445,0,0,66,66,0,1,0,1,0
56673,443,49966,443,5726,1474,4252,22,81,13,9
50014,80,33183,80,810,670,140,6,34,4,2
64094,445,0,0,70,70,0,1,0,1,0
50387,445,0,0,70,70,0,1,0,1,0
17244,22114,0,0,62,62,0,1,0,1,0
50535,80,27169,80,36985,3992,32993,56,151,25,31
54056,443,63986,443,8340,3417,4923,20,75,11,9
50284,445,0,0,66,66,0,1,0,1,0
49390,53,36883,53,210,110,100,2,30,1,1
39758,53,26339,53,86,86,0,1,30,1,0
50016,80,57935,80,827,687,140,6,32,4,2
44037,443,25209,443,5839,3664,2175,13,120,8,5
62766,443,26712,443,4911,3442,1469,29,322,16,13
63761,25933,42159,25933,436,254,182,7,15,4,3
68,67,0,0,346,346,0,1,0,1,0
51117,80,26474,80,5040,3914,1126,19,32,12,7
65085,22114,0,0,66,66,0,1,0,1,0
53854,445,0,0,70,70,0,1,0,1,0
55354,53,63415,53,214,110,104,2,30,1,1
51986,80,28001,80,1420,888,532,11,49,7,4
52447,43890,0,0,66,66,0,1,0,1,0
56924,53,48740,53,216,110,106,2,30,1,1
12530,35440,0,0,62,62,0,1,0,1,0
47422,80,55452,80,1614,1300,314,10,18,5,5
44822,40108,0,0,145,145,0,1,0,1,0
26795,443,14434,443,21804,16558,5246,43,21,24,19
50360,37965,0,0,66,66,0,1,0,1,0
56336,445,0,0,70,70,0,1,0,1,0
54796,22114,0,0,66,66,0,1,0,1,0
27038,63836,0,0,145,145,0,1,0,1,0
59769,443,37962,443,8432,1967,6465,35,68,17,18
56487,53,32287,53,194,102,92,2,30,1,1
50288,53,30921,53,764,102,662,2,30,1,1
51697,60619,59919,60619,70,70,0,1,5,1,0
52121,443,41012,443,199757,7497,192260,216,45,80,136
34737,443,45602,443,5586,1338,4248,17,109,9,8
63228,445,0,0,70,70,0,1,0,1,0
17411,43890,0,0,146,146,0,1,0,1,0
55733,53,30284,53,177,94,83,2,30,1,1
7975,53,7975,53,237,91,146,2,33,1,1
54596,443,49824,443,4510,2210,2300,14,136,7,7
49234,80,29641,80,1103248,36317,1066931,1001,162,276,725
60899,25174,0,0,66,66,0,1,0,1,0
61369,64147,0,0,66,66,0,1,0,1,0
64836,53,53586,53,241,94,147,2,30,1,1
55268,53,12955,53,193,102,91,2,29,1,1
65496,57470,0,0,146,146,0,1,0,1,0
50208,1688,32119,1688,70,70,0,2,8,2,0
53956,41578,43631,41578,492,306,186,8,17,5,3
65532,53,19828,53,819,102,717,2,30,1,1
55643,53,36774,53,183,94,89,2,30,1,1
53806,445,0,0,70,70,0,1,0,1,0
50936,80,62610,80,10423067,111935,10311132,8558,119,1601,6957
56582,37965,0,0,62,62,0,1,0,1,0
54778,22114,0,0,66,66,0,1,0,1,0
65309,53,6020,53,227,110,117,2,30,1,1
51570,445,0,0,66,66,0,1,0,1,0
51806,445,0,0,70,70,0,1,0,1,0
45157,7,33504,7,138,78,60,2,5,1,1
57385,445,0,0,70,70,0,1,0,1,0
49636,443,28958,443,50297,4871,45426,86,31,40,46
54510,445,0,0,70,70,0,1,0,1,0
64917,53,41071,53,194,94,100,2,30,1,1
52328,443,52328,443,5438,2255,3183,23,86,12,11
63364,57470,0,0,66,66,0,1,0,1,0
8080,37965,0,0,62,62,0,1,0,1,0
60619,445,0,0,66,66,0,1,0,1,0
53346,445,0,0,70,70,0,1,0,1,0
43595,443,60251,443,31194,5024,26170,44,121,18,26
55684,53,19288,53,193,102,91,2,29,1,1
57051,53,59033,53,711,87,624,2,30,1,1
64573,443,63298,443,29112,2866,26246,53,31,28,25
55183,445,0,0,70,70,0,1,0,1,0
55791,53,4698,53,811,94,717,2,30,1,1
55457,445,0,0,70,70,0,1,0,1,0
56754,443,40687,443,9868,2027,7841,24,20,12,12
13285,29892,0,0,145,145,0,1,0,1,0
64898,53,46183,53,209,94,115,2,29,1,1
65443,445,0,0,70,70,0,1,0,1,0
42576,30188,0,0,146,146,0,1,0,1,0
56068,53,7794,53,152,78,74,2,30,1,1
58567,445,0,0,66,66,0,1,0,1,0
59454,445,0,0,70,70,0,1,0,1,0
56906,53,55216,53,167,86,81,2,31,1,1
19875,30170,0,0,145,145,0,1,0,1,0
49228,53,49228,53,825,99,726,2,30,1,1
65036,53,28927,53,214,110,104,2,30,1,1
50422,50584,0,0,62,62,0,1,0,1,0
52159,80,40700,80,1278,731,547,10,15,6,4
35088,443,54099,443,800,452,348,12,94,7,5
59236,17,0,0,60,60,0,1,0,1,0
53457,443,28376,443,26693,2059,24634,42,30,18,24
61167,443,24525,443,27000,11646,15354,176,640,82,94
50929,80,17624,80,9630744,98097,9532647,7804,123,1387,6417
55126,53,61612,53,193,102,91,2,29,1,1
47788,12250,0,0,146,146,0,1,0,1,0
51218,445,0,0,70,70,0,1,0,1,0
58932,53,21682,53,168,78,90,2,31,1,1
48817,6881,48817,6881,863,363,500,4,1200,2,2
49831,30188,0,0,62,62,0,1,0,1,0
37316,443,11978,443,19840,6479,13361,57,127,32,25
57839,53,54040,53,78,78,0,1,30,1,0
58097,445,0,0,70,70,0,1,0,1,0
43732,443,8555,443,19123,2319,16804,39,28,21,18
62119,445,0,0,70,70,0,1,0,1,0
60741,445,0,0,70,70,0,1,0,1,0
52206,59077,23195,59077,316,136,180,6,9,3,3
58143,57866,0,0,66,66,0,1,0,1,0
55364,53,12032,53,168,86,82,2,30,1,1
51923,445,0,0,70,70,0,1,0,1,0
53112,445,0,0,66,66,0,1,0,1,0
4015,23117,0,0,62,62,0,1,0,1,0
57368,53,45045,53,167,86,81,2,29,1,1
52178,443,8092,443,414,140,274,7,26,3,4
53750,25174,0,0,66,66,0,1,0,1,0
40125,443,1221,443,7000,1799,5201,20,256,12,8
49999,53,5056,53,178,91,87,2,31,1,1
53196,443,1285,443,4371,1115,3256,19,19,9,10
58638,5900,0,0,62,62,0,1,0,1,0
61736,443,61172,443,148467,8298,140169,192,17,93,99
50179,80,50179,80,1473,920,553,9,137,6,3
56396,53,37010,53,183,94,89,2,30,1,1
57669,64147,0,0,62,62,0,1,0,1,0
65102,53,35796,53,183,94,89,2,30,1,1
52170,443,36243,443,7228,1589,5639,22,362,11,11
16630,44847,0,0,62,62,0,1,0,1,0
2527,53,2527,53,371,237,134,3,34,2,1
57192,445,0,0,70,70,0,1,0,1,0
57432,53,35465,53,193,102,91,2,29,1,1
33108,22,33108,22,7930,3351,4579,56,38,27,29
44680,80,65456,80,1658,922,736,10,17,6,4
59011,443,8442,443,9619,6442,3177,33,122,15,18
50581,80,61624,80,2573,1859,714,9,47,5,4
3669,53,3669,53,825,99,726,2,30,1,1
63878,50829,45177,50829,66,66,0,2,8,2,0
14693,64147,0,0,66,66,0,1,0,1,0
45402,80,27119,80,573,499,74,6,15,5,1
39545,443,12909,443,5596,3797,1799,27,96,14,13
56440,53,62063,53,212,102,110,2,30,1,1
58638,5900,0,0,62,62,0,1,0,1,0
62845,445,0,0,66,66,0,1,0,1,0
49531,53,39343,53,289,94,195,4,31,2,2
61706,80,6564,80,1840,1242,598,11,16,6,5
6889,24748,0,0,143,143,0,1,0,1,0
57396,443,49419,443,362,302,60,2,5,1,1
55891,443,55891,443,4581,1674,2907,19,30,11,8
53373,64147,0,0,66,66,0,1,0,1,0
25565,13556,0,0,60,60,0,1,0,1,0
63963,53,56258,53,262,86,176,4,46,2,2
26752,64147,0,0,62,62,0,1,0,1,0
48724,443,22721,443,4371,2036,2335,18,24,10,8
41641,443,28317,443,13106,6413,6693,24,121,12,12
52099,445,0,0,66,66,0,1,0,1,0
52559,445,0,0,70,70,0,1,0,1,0
62486,445,0,0,66,66,0,1,0,1,0
64423,445,0,0,66,66,0,1,0,1,0
59959,445,0,0,70,70,0,1,0,1,0
64798,53,2925,53,172,88,84,2,30,1,1
23844,26467,0,0,62,62,0,1,0,1,0
57397,53,56026,53,177,94,83,2,31,1,1
55376,53,1208,53,199,102,97,2,30,1,1
48817,47005,48817,47005,158,158,0,1,1200,1,0
51233,43890,0,0,66,66,0,1,0,1,0
22205,443,22205,443,10793,2049,8744,23,30,14,9
50225,445,0,0,70,70,0,1,0,1,0
64581,443,64560,443,9221,2109,7112,28,32,15,13
27005,27025,58786,27025,1634,126,1508,4,31,2,2
56232,445,0,0,70,70,0,1,0,1,0
52544,19000,32388,19000,492,216,276,2,31,1,1
57106,33000,6001,33000,223,223,0,1,30,1,0
53471,161,0,0,5907,2302,3605,22,30,11,11
49920,443,59929,443,6489,2137,4352,28,143,14,14
49584,445,0,0,66,66,0,1,0,1,0
49827,443,61208,443,5523,3016,2507,36,75,20,16
56388,53,39602,53,173,94,79,2,30,1,1
54702,445,0,0,66,66,0,1,0,1,0
5223,44091,0,0,66,66,0,1,0,1,0
34097,443,35195,443,5241,860,4381,17,15,9,8
52755,445,0,0,66,66,0,1,0,1,0
64583,445,0,0,70,70,0,1,0,1,0
5826,26467,0,0,62,62,0,1,0,1,0
58744,443,37896,443,42954,12409,30545,154,319,67,87
51802,443,43953,443,4976,1826,3150,19,151,9,10
53215,443,56280,443,6983,1629,5354,17,15,9,8
39287,57470,0,0,62,62,0,1,0,1,0
46587,57470,0,0,66,66,0,1,0,1,0
56419,53,51375,53,199,102,97,2,30,1,1
49989,53,19506,53,301,85,216,4,53,2,2
13285,29892,0,0,145,145,0,1,0,1,0
64403,53,23409,53,193,102,91,2,30,1,1
42298,40016,13493,40016,148,86,62,2,30,1,1
44220,443,37375,443,2709,1698,1011,20,1143,11,9
65017,445,0,0,70,70,0,1,0,1,0
51413,443,51090,443,63766,32148,31618,103,42,51,52
51811,20740,61529,20740,70,70,0,2,8,2,0
57598,443,59383,443,3323,2398,925,18,21,10,8
45630,443,4110,443,2996,1629,1367,17,21,9,8
59591,445,0,0,70,70,0,1,0,1,0
1033,35440,0,0,146,146,0,1,0,1,0
49577,53,58264,53,389,134,255,2,29,1,1
55732,53,62249,53,188,96,92,2,31,1,1
59773,443,43322,443,165464,10322,155142,189,71,69,120
56713,25174,0,0,146,146,0,1,0,1,0
54624,445,0,0,70,70,0,1,0,1,0
64144,53,27291,53,193,102,91,2,31,1,1
17146,57470,0,0,62,62,0,1,0,1,0
49989,443,4666,443,300,168,132,4,6,2,2
29606,53,29606,53,216,90,126,2,30,1,1
64854,53,12372,53,1431,101,1330,4,50,2,2
50658,445,0,0,70,70,0,1,0,1,0
63118,7000,63118,7000,3310,1535,1775,15,15,8,7
57314,443,14727,443,134,60,74,3,6,2,1
6889,7363,0,0,143,143,0,1,0,1,0
56703,80,22325,80,41915,4128,37787,59,64,29,30
20108,64147,0,0,66,66,0,1,0,1,0
51032,30188,0,0,66,66,0,1,0,1,0
47682,20541,0,0,62,62,0,1,0,1,0
50394,445,0,0,70,70,0,1,0,1,0
49242,53,7199,53,166,85,81,2,31,1,1
59094,445,0,0,66,66,0,1,0,1,0
51762,12747,44025,12747,70,70,0,2,8,2,0
62973,51505,0,0,62,62,0,1,0,1,0
45394,80,27437,80,4886,1260,3626,17,17,10,7
64579,445,0,0,66,66,0,1,0,1,0
32381,50584,0,0,66,66,0,1,0,1,0
57263,53,12000,53,167,86,81,2,30,1,1
54196,443,33780,443,499,425,74,4,0,3,1
64682,445,0,0,66,66,0,1,0,1,0
49369,53,65002,53,168,86,82,2,30,1,1
56719,53,51859,53,185,102,83,2,30,1,1
63670,11648,33474,11648,4501,3174,1327,26,61,16,10
61419,57470,0,0,66,66,0,1,0,1,0
56456,1433,0,0,60,60,0,1,0,1,0
55944,53,13576,53,194,94,100,2,30,1,1
57227,443,51779,443,9322,2994,6328,26,22,16,10
49980,53,9358,53,168,94,74,2,31,1,1
34783,5222,34830,5222,482,210,272,8,15,4,4
14740,26467,0,0,62,62,0,1,0,1,0
51102,80,48661,80,254,128,126,5,16,3,2
64980,53,39962,53,90,90,0,1,31,1,0
17750,1024,34469,1024,323,150,173,2,1200,1,1
56336,53,52213,53,196,102,94,2,35,1,1
51406,443,19359,443,5360,3775,1585,22,35,13,9
23317,443,22656,443,2227,1018,1209,17,15,8,9
49671,53,37210,53,182,93,89,2,31,1,1
64320,53,48665,53,199,102,97,2,30,1,1
50865,445,0,0,66,66,0,1,0,1,0
56239,80,56239,80,101707,1824,99883,96,15,26,70
15503,51413,47539,51413,459,149,310,2,1200,1,1
9479,443,13111,443,6100,777,5323,17,25,9,8
53463,29500,1810,29500,877,577,300,10,143,5,5
51516,443,35060,443,1195,634,561,12,21,7,5
57987,3478,61463,3478,60483,25857,34626,136,47,63,73
1024,57470,0,0,62,62,0,1,0,1,0
58638,5900,0,0,62,62,0,1,0,1,0
50671,443,30836,443,5409,1834,3575,25,17,12,13
64482,64147,0,0,62,62,0,1,0,1,0
5284,53,5284,53,178,82,96,2,30,1,1
34306,37965,0,0,62,62,0,1,0,1,0
52120,42751,65345,42751,70,70,0,2,8,2,0
5223,44091,0,0,66,66,0,1,0,1,0
51398,53,51398,53,197,90,107,2,30,1,1
50552,445,0,0,70,70,0,1,0,1,0
63759,64509,33605,64509,66,66,0,2,7,2,0
50593,64147,0,0,66,66,0,1,0,1,0
55026,443,35367,443,17336,5332,12004,33,121,18,15
55624,53,59892,53,308,101,207,4,53,2,2
56960,80,32758,80,6363,3790,2573,16,30,10,6
60328,445,0,0,70,70,0,1,0,1,0
56078,80,65466,80,2458,531,1927,11,75,6,5
50994,35974,0,0,60,60,0,1,0,1,0
65513,53,29862,53,195,102,93,2,31,1,1
61384,80,43597,80,2526,843,1683,12,255,7,5
46056,443,52673,443,80200,69062,11138,193,89,100,93
35657,48637,0,0,62,62,0,1,0,1,0
52217,80,27362,80,1074,565,509,11,16,6,5
60481,445,0,0,70,70,0,1,0,1,0
61150,445,0,0,66,66,0,1,0,1,0
56964,53,51072,53,174,89,85,2,31,1,1
55387,53,15050,53,195,94,101,2,29,1,1
56758,53,14411,53,165,86,79,2,30,1,1
56451,995,0,0,60,60,0,1,0,1,0
65498,53,39980,53,209,110,99,2,30,1,1
14618,6881,0,0,66,66,0,1,0,1,0
65165,53,54019,53,200,102,98,2,31,1,1
53940,445,0,0,66,66,0,1,0,1,0
55715,443,4116,443,1648,114,1534,5,120,2,3
64914,445,0,0,70,70,0,1,0,1,0
49766,80,16081,80,254,128,126,5,15,3,2
58301,53,36478,53,233,102,131,2,30,1,1
36727,443,3578,443,27009,7414,19595,46,122,21,25
14997,57470,0,0,72,72,0,1,0,1,0
56066,53,13837,53,184,102,82,2,30,1,1
63503,42707,0,0,66,66,0,1,0,1,0
59498,445,0,0,70,70,0,1,0,1,0
41294,443,46411,443,7595,1115,6480,18,35,10,8
51621,443,45721,443,5964,1007,4957,18,16,11,7
7749,36237,0,0,66,66,0,1,0,1,0
50924,445,0,0,66,66,0,1,0,1,0
58868,443,40093,443,3867,2403,1464,17,15,8,9
64649,81,0,0,60,60,0,1,0,1,0
52447,443,48925,443,7980,5952,2028,22,99,12,10
65515,22114,0,0,66,66,0,1,0,1,0
58992,443,6436,443,3049,1857,1192,20,21,9,11
55012,445,0,0,70,70,0,1,0,1,0
57917,6789,34924,6789,8164,1336,6828,34,18,18,16
52076,445,0,0,70,70,0,1,0,1,0
58243,445,0,0,70,70,0,1,0,1,0
55573,445,0,0,66,66,0,1,0,1,0
57470,54343,65136,54343,330,330,0,6,1200,6,0
36034,35440,0,0,62,62,0,1,0,1,0
50424,53,64071,53,195,102,93,2,29,1,1
24768,22114,0,0,146,146,0,1,0,1,0
50065,445,0,0,70,70,0,1,0,1,0
60367,53,22365,53,233,110,123,2,30,1,1
55732,53,61011,53,194,102,92,2,30,1,1
64348,53,23011,53,321,102,219,2,30,1,1
49863,53,59500,53,200,86,114,2,30,1,1
1042,64147,0,0,145,145,0,1,0,1,0
13160,7905,0,0,62,62,0,1,0,1,0
34529,443,32303,443,77395,64623,12772,206,188,116,90
64821,445,0,0,70,70,0,1,0,1,0
50121,53,5203,53,152,78,74,2,30,1,1
59782,53,21953,53,168,78,90,2,30,1,1
33324,42873,0,0,62,62,0,1,0,1,0
47179,53733,0,0,146,146,0,1,0,1,0
41193,443,45935,443,6035,782,5253,16,109,8,8
56354,443,18179,443,3775,1791,1984,24,203,12,12
50574,445,0,0,70,70,0,1,0,1,0
53918,443,16862,443,499,425,74,4,0,3,1
53112,29258,48583,29258,70,70,0,1,5,1,0
58981,445,0,0,70,70,0,1,0,1,0
45908,33330,0,0,60,60,0,1,0,1,0
27328,21247,0,0,62,62,0,1,0,1,0
58638,5900,0,0,62,62,0,1,0,1,0
55084,443,37269,443,5556,1438,4118,22,196,12,10
3478,61463,0,0,68,68,0,1,0,1,0
1027,25174,0,0,62,62,0,1,0,1,0
58481,53,42506,53,290,110,180,2,30,1,1
60294,30188,0,0,62,62,0,1,0,1,0
27005,32028,64745,32028,900,126,774,2,31,1,1
42971,3478,30766,3478,312,140,172,4,30,2,2
62337,44847,0,0,66,66,0,1,0,1,0
57431,15503,0,0,66,66,0,1,0,1,0
54516,445,0,0,70,70,0,1,0,1,0
60222,22114,0,0,62,62,0,1,0,1,0
55838,443,50460,443,11446,4102,7344,32,20,16,16
64576,53,63457,53,194,102,92,2,31,1,1
49265,53,12727,53,181,94,87,2,31,1,1
57733,445,0,0,66,66,0,1,0,1,0
56939,53,33751,53,351,94,257,2,30,1,1
40885,443,32340,443,4014,1592,2422,17,147,9,8
55288,53,5668,53,196,102,94,2,30,1,1
56176,443,9976,443,1312,651,661,13,185,7,6
58085,57470,0,0,66,66,0,1,0,1,0
56416,445,0,0,70,70,0,1,0,1,0
49590,57470,0,0,78,78,0,1,0,1,0
52015,25487,39642,25487,70,70,0,1,5,1,0
64286,53,59300,53,274,94,180,2,30,1,1
55030,80,10323,80,2954,671,2283,12,15,7,5
59296,445,0,0,70,70,0,1,0,1,0
45941,23386,0,0,60,60,0,1,0,1,0
36209,443,44738,443,656609,25419,631190,752,62,322,430
49555,443,34197,443,740109,22948,717161,800,54,311,489
48839,37807,0,0,62,62,0,1,0,1,0
49255,44847,0,0,66,66,0,1,0,1,0
48817,26484,48817,26484,513,152,361,2,1200,1,1
51094,35440,0,0,66,66,0,1,0,1,0
61784,445,0,0,70,70,0,1,0,1,0
63813,445,0,0,70,70,0,1,0,1,0
49712,53,30095,53,178,94,84,2,29,1,1
46461,53,27823,53,199,94,105,2,30,1,1
56598,80,2431,80,234,234,0,4,12,4,0
49676,53,9085,53,200,94,106,2,30,1,1
65134,445,0,0,70,70,0,1,0,1,0
64312,53,39914,53,209,110,99,2,30,1,1
51221,57073,10928,57073,481,150,331,2,1200,1,1
52311,80,52311,80,450,246,204,8,29,5,3
53017,445,0,0,70,70,0,1,0,1,0
64974,53,51198,53,493,111,382,4,57,2,2
49201,17852,10581,17852,66,66,0,1,5,1,0
56144,53,26768,53,180,94,86,2,30,1,1
57077,443,42602,443,7159,1851,5308,22,31,13,9
55942,53,15569,53,197,102,95,2,30,1,1
52931,443,32527,443,23112,6278,16834,140,115,55,85
10248,21247,0,0,146,146,0,1,0,1,0
55621,28144,63708,28144,70,70,0,1,5,1,0
50109,53,42164,53,198,110,88,2,30,1,1
49176,443,46832,443,2802,1902,900,22,1118,12,10
39444,53,0,0,86,86,0,1,29,1,0
27005,27020,19187,27020,890,126,764,2,30,1,1
42904,53,51732,53,308,118,190,2,30,1,1
56770,26467,0,0,66,66,0,1,0,1,0
49189,443,23027,443,9734,1613,8121,24,17,12,12
6224,37965,0,0,62,62,0,1,0,1,0
49971,53,63730,53,198,102,96,2,30,1,1
5588,5588,0,0,3562,1936,1626,48,195,24,24
64111,1830,17922,1830,66,66,0,2,8,2,0
62400,35993,0,0,66,66,0,1,0,1,0
53760,45682,20604,45682,70,70,0,1,4,1,0
443,56858,0,0,85,85,0,1,0,1,0
49270,53,27956,53,216,110,106,2,31,1,1
10312,23117,0,0,62,62,0,1,0,1,0
54274,445,0,0,70,70,0,1,0,1,0
7532,53,7532,53,228,90,138,2,31,1,1
50488,22114,0,0,66,66,0,1,0,1,0
49484,53,47845,53,742,88,654,2,31,1,1
56173,37807,0,0,66,66,0,1,0,1,0
64675,53,55719,53,749,94,655,2,31,1,1
51934,36180,0,0,62,62,0,1,0,1,0
62392,15503,0,0,146,146,0,1,0,1,0
56550,53,53287,53,166,86,80,2,29,1,1
49411,445,0,0,70,70,0,1,0,1,0
54325,27016,47516,27016,924,924,0,3,30,3,0
50260,53,50381,53,196,86,110,2,30,1,1
59220,445,0,0,70,70,0,1,0,1,0
61852,445,0,0,66,66,0,1,0,1,0
57293,25174,0,0,146,146,0,1,0,1,0
53202,443,37949,443,6043,1568,4475,11,120,4,7
65161,53,65161,53,256,114,142,2,30,1,1
52866,445,0,0,70,70,0,1,0,1,0
443,62451,0,0,199,199,0,1,0,1,0
64904,53,63887,53,199,102,97,2,30,1,1
54147,443,52345,443,3334,331,3003,10,120,5,5
52138,445,0,0,70,70,0,1,0,1,0
64305,53,21382,53,598,196,402,6,71,3,3
57593,443,14217,443,7037,1786,5251,23,200,13,10
63988,50584,0,0,66,66,0,1,0,1,0
0,0,0,0,156,156,0,2,0,2,0
51066,445,0,0,66,66,0,1,0,1,0
64172,445,0,0,70,70,0,1,0,1,0
61200,445,0,0,70,70,0,1,0,1,0
63051,445,0,0,66,66,0,1,0,1,0
40763,443,27693,443,15679,4305,11374,32,43,17,15
64796,53,48263,53,184,94,90,2,31,1,1
65081,26467,0,0,66,66,0,1,0,1,0
63225,443,50090,443,4882,2412,2470,32,155,16,16
25276,50584,0,0,146,146,0,1,0,1,0
60420,443,16410,443,7330,1565,5765,20,134,10,10
43600,443,57317,443,172272,14401,157871,254,418,100,154
51602,22114,0,0,66,66,0,1,0,1,0
57398,53,47898,53,232,110,122,2,30,1,1
55853,53,55965,53,197,102,95,2,30,1,1
52193,443,50924,443,13948,1150,12798,29,15,14,15
51972,13604,43742,13604,160,70,90,2,5,1,1
38795,40042,2140,40042,142,80,62,2,31,1,1
61515,445,0,0,66,66,0,1,0,1,0
55616,445,0,0,66,66,0,1,0,1,0
58909,445,0,0,70,70,0,1,0,1,0
60284,80,50056,80,1430,754,676,11,146,6,5
45964,2225,0,0,60,60,0,1,0,1,0
65251,53,30637,53,196,102,94,2,30,1,1
60702,445,0,0,70,70,0,1,0,1,0
5223,14446,0,0,220,220,0,1,0,1,0
62064,22114,0,0,66,66,0,1,0,1,0
53991,445,0,0,66,66,0,1,0,1,0
56648,53,6533,53,198,101,97,2,31,1,1
53169,44707,23330,44707,1078,518,560,16,21,9,7
33947,443,18903,443,25302,10587,14715,88,123,37,51
43584,26543,0,0,156,156,0,1,0,1,0
54560,53,54560,53,832,106,726,2,30,1,1
64790,53,41901,53,178,94,84,2,29,1,1
50331,80,36568,80,1677,862,815,10,15,5,5
56991,443,56991,443,6305,1352,4953,19,16,10,9
46341,443,54451,443,9172,3518,5654,39,103,21,18
56128,53,30035,53,744,89,655,2,31,1,1
50423,445,0,0,70,70,0,1,0,1,0
62685,445,0,0,70,70,0,1,0,1,0
48753,80,48753,80,19937,2162,17775,36,24,19,17
62549,53733,0,0,66,66,0,1,0,1,0
6889,65473,0,0,143,143,0,1,0,1,0
64741,53,21274,53,198,86,112,2,29,1,1
42853,443,43627,443,3508,2120,1388,20,241,10,10
60432,54312,22904,54312,701,455,246,8,15,4,4
50530,445,0,0,70,70,0,1,0,1,0
65477,53,60369,53,182,93,89,2,31,1,1
55056,56205,0,0,62,62,0,1,0,1,0
54434,445,0,0,70,70,0,1,0,1,0
55144,30188,0,0,66,66,0,1,0,1,0
50672,443,34507,443,6202,1828,4374,25,18,12,13
65438,53,17432,53,332,94,238,2,29,1,1
55503,53,56462,53,216,110,106,2,30,1,1
56505,443,54192,443,78426,3219,75207,98,96,37,61
62073,443,32648,443,9559,3243,6316,28,46,16,12
64366,445,0,0,66,66,0,1,0,1,0
55808,53,41787,53,183,94,89,2,30,1,1
64933,53,1484,53,738,86,652,2,31,1,1
62654,35440,0,0,62,62,0,1,0,1,0
55835,53,25257,53,180,94,86,2,30,1,1
49944,80,49944,80,220279,13007,207272,266,22,115,151
56606,53,17065,53,762,97,665,2,31,1,1
50187,53,34456,53,168,78,90,2,30,1,1
55053,80,18063,80,162010,4343,157667,170,98,61,109
50210,53,56208,53,756,94,662,2,29,1,1
64579,53,56844,53,178,94,84,2,30,1,1
55241,443,32846,443,8080,2630,5450,24,45,12,12
64650,53,46019,53,193,94,99,2,30,1,1
49860,53,13520,53,550,129,421,4,57,2,2
60952,443,35261,443,391561,17125,374436,478,17,213,265
52987,445,0,0,70,70,0,1,0,1,0
63758,445,0,0,66,66,0,1,0,1,0
53172,56013,23634,56013,70,70,0,1,5,1,0
40834,50584,0,0,62,62,0,1,0,1,0
52744,53,32462,53,218,81,137,2,31,1,1
54610,443,15531,443,19810,7047,12763,54,438,28,26
49641,443,54383,443,5776,1079,4697,15,53,8,7
58350,445,0,0,70,70,0,1,0,1,0
41577,53,41577,53,265,111,154,2,0,1,1
50047,443,50047,443,4534,1627,2907,19,27,11,8
60146,53,47250,53,218,78,140,2,30,1,1
51221,51413,63036,51413,459,149,310,2,1200,1,1
55094,445,0,0,66,66,0,1,0,1,0
55005,53,64520,53,183,94,89,2,30,1,1
55708,445,0,0,70,70,0,1,0,1,0
50437,53,50192,53,413,170,243,6,30,3,3
57260,51221,0,0,66,66,0,1,0,1,0
26900,27017,60597,27017,422,164,258,6,31,3,3
12545,25174,0,0,62,62,0,1,0,1,0
26953,30317,0,0,62,62,0,1,0,1,0
51174,443,5740,443,12037,3531,8506,35,271,18,17
53723,443,51817,443,70,70,0,1,5,1,0
2849,30188,0,0,66,66,0,1,0,1,0
54418,22114,0,0,66,66,0,1,0,1,0
55889,53,19175,53,177,94,83,2,29,1,1
51617,21247,0,0,66,66,0,1,0,1,0
64330,53,10524,53,193,102,91,2,30,1,1
35558,15503,0,0,66,66,0,1,0,1,0
62287,443,17565,443,3644,610,3034,13,119,6,7
59568,445,0,0,70,70,0,1,0,1,0
57665,52700,0,0,66,66,0,1,0,1,0
12266,443,12266,443,18634,3895,14739,48,29,27,21
56659,443,25934,443,1579,988,591,13,24,7,6
54105,80,38446,80,78,78,0,1,5,1,0
63988,445,0,0,66,66,0,1,0,1,0
51046,53,51046,53,244,106,138,2,30,1,1
55635,38649,44116,38649,70,70,0,1,5,1,0
51222,445,0,0,70,70,0,1,0,1,0
50075,445,0,0,70,70,0,1,0,1,0
49452,443,53461,443,13184,2507,10677,27,64,14,13
43918,5228,35546,5228,2276,1356,920,15,3601,7,8
57507,7000,57507,7000,3562,1995,1567,16,15,9,7
64793,53,59763,53,168,86,82,2,31,1,1
55583,445,0,0,66,66,0,1,0,1,0
50318,80,21534,80,3855,828,3027,11,15,5,6
54973,53,49914,53,811,94,717,2,29,1,1
61798,35440,0,0,66,66,0,1,0,1,0
56489,53,51415,53,178,94,84,2,30,1,1
62122,445,0,0,66,66,0,1,0,1,0
49533,443,49533,443,20402,16563,3839,29,24,17,12
58999,53,58999,53,825,99,726,2,30,1,1
51920,443,50819,443,98155,20830,77325,151,103,70,81
51142,443,51142,443,261206,9686,251520,308,128,121,187
49706,443,36455,443,32941,1850,31091,46,131,19,27
49978,53,17082,53,195,102,93,2,31,1,1
42601,443,52311,443,3238,2021,1217,16,16,8,8
56224,53,54618,53,221,102,119,2,30,1,1
64407,53,18646,53,232,110,122,2,29,1,1
49924,443,9177,443,13502,2331,11171,42,194,19,23
65002,27064,63916,27064,735,462,273,2,30,1,1
50680,443,16561,443,7066,1129,5937,19,172,9,10
63775,445,0,0,70,70,0,1,0,1,0
19136,64147,0,0,62,62,0,1,0,1,0
55056,56205,0,0,66,66,0,1,0,1,0
58638,5900,0,0,62,62,0,1,0,1,0
64661,445,0,0,66,66,0,1,0,1,0
53469,445,0,0,70,70,0,1,0,1,0
49780,445,0,0,70,70,0,1,0,1,0
51785,33253,14709,33253,70,70,0,2,8,2,0
52426,53,52426,53,310,94,216,2,31,1,1
50470,61463,0,0,86,86,0,1,0,1,0
62828,445,0,0,70,70,0,1,0,1,0
64000,44847,0,0,66,66,0,1,0,1,0
57454,443,10249,443,4881,1817,3064,30,135,16,14
52129,55550,34471,55550,66,66,0,1,5,1,0
64818,445,0,0,70,70,0,1,0,1,0
59070,445,0,0,70,70,0,1,0,1,0
64690,445,0,0,70,70,0,1,0,1,0
53534,40960,13903,40960,320,140,180,6,6,3,3
20280,30188,0,0,146,146,0,1,0,1,0
62424,37965,0,0,62,62,0,1,0,1,0
56336,53,53884,53,196,102,94,2,35,1,1
53217,443,21683,443,6058,1038,5020,20,66,11,9
50319,53,7471,53,194,102,92,2,30,1,1
27005,1308,46544,1308,855,126,729,2,30,1,1
52971,445,0,0,70,70,0,1,0,1,0
36262,443,11222,443,678861,22499,656362,749,19,290,459
57664,80,57664,80,1917,1468,449,10,19,6,4
52060,29868,16909,29868,70,70,0,2,8,2,0
57210,445,0,0,70,70,0,1,0,1,0
3068,36237,0,0,62,62,0,1,0,1,0
56713,443,29098,443,373053,9725,363328,374,45,129,245
50640,445,0,0,70,70,0,1,0,1,0
27783,57470,0,0,62,62,0,1,0,1,0
49931,53,19319,53,190,97,93,2,31,1,1
57470,1337,11046,1337,132,132,0,3,1199,3,0
43208,443,45939,443,4296557,96359,4200198,3781,143,838,2943
49444,53,27495,53,199,94,105,2,30,1,1
64706,27065,37449,27065,924,924,0,3,30,3,0
51504,445,0,0,66,66,0,1,0,1,0
56674,53,20676,53,183,94,89,2,30,1,1
37593,443,32259,443,21234,9602,11632,48,70,28,20
56872,445,0,0,66,66,0,1,0,1,0
50072,53,22723,53,779,86,693,2,30,1,1
46479,443,13902,443,5241,2026,3215,50,6660,18,32
52847,445,0,0,70,70,0,1,0,1,0
57555,35440,0,0,66,66,0,1,0,1,0
17177,64147,0,0,62,62,0,1,0,1,0
64763,445,0,0,70,70,0,1,0,1,0
58638,5900,0,0,62,62,0,1,0,1,0
65443,53,23920,53,172,94,78,2,30,1,1
63743,445,0,0,70,70,0,1,0,1,0
58761,443,45887,443,318,192,126,6,26,4,2
16660,55783,0,0,62,62,0,1,0,1,0
64160,445,0,0,66,66,0,1,0,1,0
28839,30188,0,0,62,62,0,1,0,1,0
55144,443,25818,443,6918,2826,4092,26,21,16,10
50708,445,0,0,66,66,0,1,0,1,0
56977,53,42818,53,273,102,171,2,30,1,1
55365,53,41996,53,184,94,90,2,31,1,1
49996,53,6579,53,183,94,89,2,30,1,1
60287,80,59923,80,10135,7433,2702,28,164,19,9
52738,443,34014,443,56339,3530,52809,79,26,39,40
63795,52376,47084,52376,66,66,0,2,8,2,0
59051,27520,0,0,62,62,0,1,0,1,0
36352,443,46352,443,3256,1753,1503,17,315,10,7
55105,445,0,0,70,70,0,1,0,1,0
49923,53,8519,53,702,194,508,6,67,3,3
65115,53,24765,53,186,95,91,2,30,1,1
58638,5900,0,0,62,62,0,1,0,1,0
26922,443,5779,443,7647,2890,4757,23,20,11,12
45652,10214,0,0,62,62,0,1,0,1,0
58718,80,58718,80,106571,3881,102690,128,16,56,72
55706,445,0,0,66,66,0,1,0,1,0
55079,25174,0,0,66,66,0,1,0,1,0
51938,445,0,0,70,70,0,1,0,1,0
56711,443,47786,443,8005,1985,6020,20,15,11,9
49386,64147,0,0,62,62,0,1,0,1,0
49797,53,51758,53,718,94,624,2,30,1,1
58577,445,0,0,70,70,0,1,0,1,0
39351,23,0,0,60,60,0,1,0,1,0
59234,21247,0,0,62,62,0,1,0,1,0
49869,53,64308,53,209,110,99,2,30,1,1
65068,445,0,0,70,70,0,1,0,1,0
49690,53,46468,53,198,94,104,2,30,1,1
55235,53,63921,53,178,94,84,2,30,1,1
62295,445,0,0,66,66,0,1,0,1,0
993,54634,0,0,66,66,0,1,90,1,0
54074,445,0,0,70,70,0,1,0,1,0
9997,53,9997,53,235,90,145,2,32,1,1
50306,53,23964,53,814,110,704,2,30,1,1
52863,50584,0,0,66,66,0,1,0,1,0
53753,443,14141,443,6973,2166,4807,20,15,11,9
25085,30188,0,0,62,62,0,1,0,1,0
65456,445,0,0,70,70,0,1,0,1,0
3818,37965,0,0,66,66,0,1,0,1,0
61218,445,0,0,70,70,0,1,0,1,0
49562,443,58637,443,9908,4692,5216,30,92,16,14
61033,445,0,0,70,70,0,1,0,1,0
56592,53,8567,53,262,94,168,2,30,1,1
8536,37965,0,0,62,62,0,1,0,1,0
57606,443,40796,443,11986,3075,8911,60,4981,31,29
62050,443,56297,443,7955,2503,5452,33,16,19,14
31745,2323,0,0,60,60,0,1,0,1,0
26531,25174,0,0,62,62,0,1,0,1,0
58638,5900,0,0,62,62,0,1,0,1,0
49245,53,64738,53,195,102,93,2,30,1,1
55503,53,44075,53,216,110,106,2,30,1,1
55620,53,6956,53,178,94,84,2,31,1,1
64030,445,0,0,70,70,0,1,0,1,0
43324,22,43324,22,8157,3445,4712,59,43,28,31
55475,80,10225,80,350,210,140,6,27,4,2
58865,443,1630,443,505070,16437,488633,543,45,187,356
56920,53,48525,53,184,78,106,2,30,1,1
55081,443,63191,443,19866,7188,12678,18,151,7,11
26989,80,26989,80,256062,8754,247308,297,18,124,173
55825,52700,0,0,62,62,0,1,0,1,0
35023,53,0,0,82,82,0,2,40,2,0
49435,53,64990,53,608,199,409,6,69,3,3
2572,17546,0,0,62,62,0,1,0,1,0
57222,53,51448,53,177,94,83,2,30,1,1
56572,53,22035,53,177,94,83,2,29,1,1
5179,50265,0,0,62,62,0,1,0,1,0
65152,53,30200,53,177,94,83,2,30,1,1
56334,1433,0,0,60,60,0,1,0,1,0
50357,443,38830,443,1786,172,1614,7,121,3,4
19473,35726,44271,35726,481,150,331,2,1200,1,1
56824,55829,39772,55829,70,70,0,1,5,1,0
55324,445,0,0,70,70,0,1,0,1,0
56072,53,60907,53,198,101,97,2,31,1,1
16387,22272,0,0,60,60,0,1,0,1,0
59613,445,0,0,70,70,0,1,0,1,0
64209,53,40539,53,291,94,197,2,29,1,1
41739,53,41739,53,235,90,145,2,32,1,1
38565,51505,0,0,62,62,0,1,0,1,0
41003,5000,0,0,60,60,0,1,0,1,0
49459,53,35212,53,199,102,97,2,31,1,1
10151,6881,1638,6881,460,150,310,2,1200,1,1
43657,50011,0,0,62,62,0,1,0,1,0
30303,30303,0,0,171,171,0,1,0,1,0
23333,53,23333,53,215,80,135,2,33,1,1
49655,443,10531,443,31956,13344,18612,64,65,36,28
60493,445,0,0,66,66,0,1,0,1,0
49942,53,37670,53,196,94,102,2,31,1,1
6881,6881,0,0,146,146,0,1,0,1,0
36403,443,54491,443,1149,709,440,13,39,8,5
49250,53,20588,53,731,85,646,2,30,1,1
53746,36237,0,0,66,66,0,1,0,1,0
55380,53,27233,53,289,97,192,4,45,2,2
47744,80,34323,80,1571,877,694,11,180,6,5
41902,443,1832,443,6511,1866,4645,21,17,12,9
49786,443,41630,443,10079,2855,7224,23,126,12,11
39531,19473,0,0,62,62,0,1,0,1,0
56509,53,49839,53,1165,94,1071,2,30,1,1
58888,443,23971,443,7329,949,6380,17,35,7,10
56625,53,59531,53,186,95,91,2,31,1,1
59042,445,0,0,66,66,0,1,0,1,0
62597,445,0,0,70,70,0,1,0,1,0
54922,445,0,0,70,70,0,1,0,1,0
53816,22114,0,0,146,146,0,1,0,1,0
19875,30170,0,0,145,145,0,1,0,1,0
60443,445,0,0,70,70,0,1,0,1,0
49236,53,51973,53,377,94,283,2,30,1,1
49418,27016,58886,27016,242,78,164,2,30,1,1
41314,80,2894,80,1723,438,1285,10,136,6,4
65271,445,0,0,66,66,0,1,0,1,0
65350,53,62383,53,168,86,82,2,30,1,1
44389,53,44389,53,235,90,145,2,32,1,1
51963,22114,0,0,66,66,0,1,0,1,0
7166,64147,0,0,66,66,0,1,0,1,0
52019,40689,48482,40689,70,70,0,2,8,2,0
59871,445,0,0,70,70,0,1,0,1,0
56198,53,28713,53,184,102,82,2,30,1,1
56316,53,62474,53,733,93,640,2,31,1,1
61977,445,0,0,66,66,0,1,0,1,0
7992,64147,0,0,62,62,0,1,0,1,0
65128,445,0,0,66,66,0,1,0,1,0
58905,443,41213,443,13055,5677,7378,29,122,15,14
57453,443,43967,443,2233,1347,886,23,135,13,10
38774,80,38774,80,369073,4523,364550,316,142,59,257
7249,30349,0,0,143,143,0,1,0,1,0
49867,445,0,0,70,70,0,1,0,1,0
56781,443,59501,443,7870,1881,5989,20,15,11,9
58857,443,61452,443,674,130,544,11,129,3,8
49212,80,1671,80,1013,566,447,8,134,5,3
55626,53,3780,53,319,126,193,2,29,1,1
53979,443,21511,443,3566,871,2695,11,120,5,6
64709,53,54232,53,338,110,228,2,29,1,1
60324,445,0,0,70,70,0,1,0,1,0
58801,445,0,0,70,70,0,1,0,1,0
64677,57470,0,0,66,66,0,1,0,1,0
58263,443,17697,443,12494,5331,7163,48,122,21,27
58092,445,0,0,70,70,0,1,0,1,0
42034,28189,0,0,62,62,0,1,0,1,0
51571,445,0,0,70,70,0,1,0,1,0
61217,53,50317,53,281,94,187,2,30,1,1
2267,53,42274,53,204,118,86,2,31,1,1
63092,46776,0,0,78,78,0,1,0,1,0
50216,443,60442,443,6320,1382,4938,24,167,13,11
49635,53,38499,53,210,110,100,2,29,1,1
65092,53,51583,53,263,94,169,2,30,1,1
56701,445,0,0,70,70,0,1,0,1,0
50169,445,0,0,70,70,0,1,0,1,0
58046,443,58046,443,4682,1775,2907,19,29,11,8
60354,80,7611,80,644,256,388,8,124,5,3
51099,80,52841,80,3422,1962,1460,33,131,18,15
49803,80,1813,80,2553,1621,932,13,126,8,5
59920,445,0,0,66,66,0,1,0,1,0
49461,53,21062,53,821,102,719,2,29,1,1
1038,37965,0,0,62,62,0,1,0,1,0
56421,53,8309,53,177,94,83,2,30,1,1
65071,445,0,0,70,70,0,1,0,1,0
64084,445,0,0,66,66,0,1,0,1,0
20844,64147,0,0,66,66,0,1,0,1,0
56749,443,28025,443,8058,2038,6020,20,15,11,9
54151,443,32501,443,1749,966,783,13,75,8,5
50478,80,50478,80,28032,3868,24164,47,24,23,24
50581,445,0,0,70,70,0,1,0,1,0
35212,443,35212,443,4700,1793,2907,19,27,11,8
65338,53,10255,53,314,88,226,4,44,2,2
45941,23388,0,0,60,60,0,1,0,1,0
64636,53,42647,53,727,223,504,6,70,3,3
49370,443,33059,443,5782,1008,4774,17,1,8,9
63015,445,0,0,70,70,0,1,0,1,0
53791,16881,62073,16881,70,70,0,2,8,2,0
55065,53,19490,53,711,87,624,2,30,1,1
59668,50584,0,0,66,66,0,1,0,1,0
56047,443,45831,443,126,60,66,3,4,2,1
68,67,0,0,346,346,0,1,0,1,0
57134,53,29907,53,178,94,84,2,30,1,1
7905,22114,0,0,62,62,0,1,0,1,0
52858,443,52858,443,313243,267937,45306,456,5925,210,246
64346,51505,0,0,66,66,0,1,0,1,0
49559,443,14886,443,1332,876,456,11,56,6,5
16620,25174,0,0,62,62,0,1,0,1,0
33410,80,44582,80,1570,754,816,10,15,6,4
57845,445,0,0,66,66,0,1,0,1,0
49566,80,39778,80,10134,1142,8992,24,46,12,12
49353,443,32645,443,7030,1195,5835,20,76,10,10
1046,25174,0,0,146,146,0,1,0,1,0
51810,33776,19037,33776,70,70,0,2,8,2,0
54677,5228,25400,5228,6679,2730,3949,43,4309,23,20
59257,445,0,0,66,66,0,1,0,1,0
20706,37965,0,0,62,62,0,1,0,1,0
34932,38608,0,0,62,62,0,1,0,1,0
62320,445,0,0,70,70,0,1,0,1,0
53921,18183,42637,18183,826,386,440,12,15,6,6
52374,445,0,0,70,70,0,1,0,1,0
65446,445,0,0,70,70,0,1,0,1,0
29895,23,0,0,60,60,0,1,0,1,0
65073,80,65073,80,169702,10513,159189,187,23,72,115
62570,445,0,0,70,70,0,1,0,1,0
60544,53,63580,53,211,78,133,2,30,1,1
1130,37965,0,0,145,145,0,1,0,1,0
57183,53,6659,53,178,94,84,2,31,1,1
39380,1,0,0,146,146,0,1,0,1,0
20108,64147,0,0,62,62,0,1,0,1,0
55095,53,54084,53,783,96,687,2,30,1,1
65477,53,50858,53,209,110,99,2,30,1,1
49688,445,0,0,70,70,0,1,0,1,0
56710,53,43417,53,190,97,93,2,31,1,1
53889,19002,16357,19002,552,306,246,9,15,5,4
58793,443,26304,443,5167,700,4467,16,15,7,9
56419,53,8331,53,198,101,97,2,30,1,1
49023,5223,46497,5223,70,70,0,2,5,2,0
44921,53,22635,53,168,78,90,2,30,1,1
63556,445,0,0,70,70,0,1,0,1,0
55102,445,0,0,66,66,0,1,0,1,0
16403,16384,56995,16384,556,256,300,10,31,5,5
65265,55067,0,0,62,62,0,1,0,1,0
49762,53,56822,53,184,94,90,2,31,1,1
56105,53,14961,53,372,142,230,2,29,1,1
37650,443,41900,443,6898,5202,1696,25,25,15,10
63943,53,31455,53,254,110,144,2,30,1,1
45439,443,28530,443,24785,17234,7551,68,421,36,32
50675,445,0,0,66,66,0,1,0,1,0
44654,80,35775,80,2121,1558,563,13,16,7,6
35132,53,35132,53,469,165,304,4,31,2,2
45941,23386,0,0,60,60,0,1,0,1,0
54821,445,0,0,70,70,0,1,0,1,0
26698,25174,0,0,66,66,0,1,0,1,0
50899,80,62536,80,13974043,173337,13800706,11715,134,2429,9286
55319,443,12527,443,6210,2720,3490,15,121,7,8
57394,53,16872,53,186,95,91,2,31,1,1
45908,33330,0,0,60,60,0,1,0,1,0
62920,445,0,0,70,70,0,1,0,1,0
51341,7000,51341,7000,3132,815,2317,14,16,7,7
55068,53,54785,53,196,102,94,2,30,1,1
55503,53,12220,53,200,102,98,2,30,1,1
27969,25174,0,0,62,62,0,1,0,1,0
41541,25174,0,0,66,66,0,1,0,1,0
60232,53,0,0,202,86,116,2,29,1,1
62747,445,0,0,66,66,0,1,0,1,0
58009,80,11441,80,495,192,303,6,21,4,2
59270,445,0,0,70,70,0,1,0,1,0
26408,64147,0,0,66,66,0,1,0,1,0
61333,445,0,0,66,66,0,1,0,1,0
50265,53606,10997,53606,528,528,0,9,1200,9,0
10028,25604,0,0,62,62,0,1,0,1,0
35132,53,35132,53,86,86,0,1,30,1,0
56654,443,1981,443,8007,1987,6020,20,15,11,9
53045,445,0,0,70,70,0,1,0,1,0
55591,53,22310,53,195,102,93,2,30,1,1
50652,445,0,0,70,70,0,1,0,1,0
57395,53,64683,53,262,88,174,4,58,2,2
57364,445,0,0,70,70,0,1,0,1,0
38194,53,38194,53,210,98,112,2,29,1,1
54335,445,0,0,70,70,0,1,0,1,0
51263,443,57364,443,162,102,60,2,5,1,1
6881,6881,57384,6881,238,118,120,2,1200,1,1
52622,445,0,0,70,70,0,1,0,1,0
64538,53,8098,53,194,102,92,2,29,1,1
52232,35126,34717,35126,70,70,0,1,5,1,0
51480,3027,51480,3027,156,156,0,3,8,3,0
55933,64097,0,0,62,62,0,1,0,1,0
55718,16805,42718,16805,70,70,0,2,8,2,0
57173,44847,0,0,62,62,0,1,0,1,0
54749,443,23422,443,273283,194709,78574,1567,3312,746,821
58264,44847,0,0,66,66,0,1,0,1,0
64149,53,17311,53,301,108,193,4,49,2,2
51927,445,0,0,70,70,0,1,0,1,0
58847,445,0,0,70,70,0,1,0,1,0
37093,53,37093,53,645,90,555,2,29,1,1
11030,17372,0,0,62,62,0,1,0,1,0
52332,445,0,0,70,70,0,1,0,1,0
56941,53,56569,53,193,102,91,2,30,1,1
49266,53,8623,53,86,86,0,1,30,1,0
16377,21247,0,0,62,62,0,1,0,1,0
19298,30188,0,0,62,62,0,1,0,1,0
1404,51180,0,0,145,145,0,1,0,1,0
49686,80,54142,80,2611,1811,800,13,15,7,6
52323,44847,0,0,146,146,0,1,0,1,0
52122,445,0,0,70,70,0,1,0,1,0
2919,37965,0,0,62,62,0,1,0,1,0
62768,445,0,0,70,70,0,1,0,1,0
49824,53,50073,53,198,94,104,2,30,1,1
49690,50265,0,0,62,62,0,1,0,1,0
60152,80,38610,80,1056,682,374,10,15,6,4
55452,53,8362,53,184,94,90,2,29,1,1
56907,53,55203,53,193,102,91,2,30,1,1
41677,57470,0,0,66,66,0,1,0,1,0
55176,53,23619,53,195,102,93,2,30,1,1
42030,25,0,0,74,74,0,1,0,1,0
40054,62413,0,0,62,62,0,1,0,1,0
61613,445,0,0,66,66,0,1,0,1,0
26849,443,35279,443,20979,15982,4997,38,36,22,16
51843,80,51843,80,35384,3225,32159,49,26,20,29
50014,445,0,0,70,70,0,1,0,1,0
59586,56205,0,0,62,62,0,1,0,1,0
56006,53,14148,53,200,102,98,2,30,1,1
64047,16221,34665,16221,66,66,0,2,8,2,0
49905,53,29720,53,180,94,86,2,30,1,1
443,50238,0,0,60,60,0,1,0,1,0
41554,53,50330,53,199,94,105,2,30,1,1
47640,443,10100,443,1058,571,487,10,38,6,4
50625,445,0,0,70,70,0,1,0,1,0
53711,30355,27778,30355,320,140,180,6,5,3,3
58290,445,0,0,70,70,0,1,0,1,0
61876,445,0,0,70,70,0,1,0,1,0
33842,53,33842,53,1415,689,726,3,31,2,1
49334,53,14859,53,184,94,90,2,30,1,1
47531,8080,0,0,184,78,106,3,10,2,1
50604,443,50604,443,4716,1809,2907,19,30,11,8
52075,80,29185,80,422,240,182,8,25,5,3
60689,445,0,0,70,70,0,1,0,1,0
49467,53,63815,53,811,94,717,2,30,1,1
64665,445,0,0,70,70,0,1,0,1,0
50542,443,2915,443,6787,1846,4941,24,361,11,13
59440,445,0,0,66,66,0,1,0,1,0
65487,53,2041,53,210,110,100,2,29,1,1
65343,53,41692,53,184,94,90,2,29,1,1
50877,30041,0,0,66,66,0,1,0,1,0
51221,41939,7547,41939,3917,1584,2333,50,3325,25,25
53423,445,0,0,70,70,0,1,0,1,0
61666,445,0,0,66,66,0,1,0,1,0
37653,5223,9635,5223,417,417,0,4,13,4,0
56710,53,52813,53,177,94,83,2,30,1,1
63988,22114,0,0,66,66,0,1,0,1,0
52169,59681,50827,59681,70,70,0,2,8,2,0
60794,20010,30261,20010,70,70,0,2,8,2,0
55913,53,60589,53,177,94,83,2,30,1,1
53126,47035,16520,47035,70,70,0,2,8,2,0
59680,80,46564,80,5762500,128192,5634308,5613,134,1854,3759
60410,80,39027,80,186,64,122,4,27,2,2
52021,32202,28754,32202,66,66,0,1,5,1,0
55934,445,0,0,66,66,0,1,0,1,0
62067,445,0,0,70,70,0,1,0,1,0
49882,443,51154,443,79524,18512,61012,205,50,101,104
62328,443,62328,443,1210,637,573,14,51,7,7
60461,443,30128,443,18515,2899,15616,32,148,15,17
55711,53,26039,53,177,94,83,2,29,1,1
26953,30317,0,0,62,62,0,1,0,1,0
52069,443,58319,443,8593,2221,6372,31,232,17,14
24041,55783,0,0,62,62,0,1,0,1,0
55494,80,14370,80,188544,9826,178718,241,32,113,128
65241,53,34581,53,198,102,96,2,30,1,1
27922,25174,0,0,62,62,0,1,0,1,0
36601,443,32906,443,16455,11185,5270,37,271,22,15
56695,53,57441,53,776,102,674,2,30,1,1
39312,443,51370,443,10148,2203,7945,37,120,19,18
47674,443,2134,443,7576,2983,4593,33,42,18,15
51221,20864,10145,20864,7308,6812,496,71,3243,63,8
49296,443,32357,443,50454,5259,45195,52,105,17,35
27005,27016,42584,27016,1010,252,758,4,33,3,1
56892,445,0,0,70,70,0,1,0,1,0
52537,37965,0,0,66,66,0,1,0,1,0
57459,51505,0,0,62,62,0,1,0,1,0
12143,56205,0,0,66,66,0,1,0,1,0
65318,53,18281,53,184,94,90,2,30,1,1
57805,445,0,0,66,66,0,1,0,1,0
13062,52274,0,0,66,66,0,1,0,1,0
62504,443,1666,443,10385,7051,3334,27,33,15,12
64813,53,27372,53,176,90,86,2,30,1,1
62307,8055,0,0,159,159,0,1,0,1,0
53907,45622,50876,45622,70,70,0,2,7,2,0
50611,80,6797,80,2933,1237,1696,12,20,7,5
57275,53,15169,53,193,102,91,2,30,1,1
62722,443,49389,443,3491257,62261,3428996,3146,155,768,2378
34158,53,34158,53,217,87,130,2,30,1,1
64726,53,39418,53,178,94,84,2,30,1,1
59422,51221,0,0,62,62,0,1,0,1,0
49274,53,46367,53,194,99,95,2,31,1,1
11692,25174,0,0,66,66,0,1,0,1,0
55393,44512,0,0,66,66,0,1,0,1,0
49418,27016,26293,27016,257,71,186,2,30,1,1
53261,443,49163,443,12912,4288,8624,43,20,22,21
60290,53,25533,53,199,94,105,2,29,1,1
57189,53,13765,53,78,78,0,1,30,1,0
58840,445,0,0,70,70,0,1,0,1,0
56816,53,22918,53,233,94,139,2,30,1,1
49687,53,60160,53,197,102,95,2,31,1,1
51112,80,46143,80,2433,1280,1153,11,20,7,4
64349,445,0,0,70,70,0,1,0,1,0
63966,443,14721,443,22930,2512,20418,37,75,17,20
60711,443,38043,443,12258,1451,10807,27,360,13,14
48808,443,13852,443,8192,2071,6121,23,361,10,13
56688,443,37544,443,32780,6864,25916,142,345,57,85
64049,445,0,0,70,70,0,1,0,1,0
52177,21079,54277,21079,316,136,180,6,5,3,3
63834,27037,60626,27037,1592,1386,206,6,31,4,2
60107,443,49027,443,9766,3290,6476,40,57,20,20
57972,445,0,0,66,66,0,1,0,1,0
41776,443,6550,443,32434,15588,16846,164,1128,83,81
64073,53,57961,53,304,101,203,4,38,2,2
60601,443,55669,443,6180,926,5254,18,36,10,8
60665,445,0,0,70,70,0,1,0,1,0
58638,5900,0,0,62,62,0,1,0,1,0
2904,44847,0,0,78,78,0,1,0,1,0
37511,443,37511,443,4673,1766,2907,19,26,11,8
56654,443,53376,443,4972,2136,2836,21,24,12,9
49201,17852,9879,17852,70,70,0,2,8,2,0
35073,443,44227,443,6201,1790,4411,24,330,13,11
52804,443,52702,443,70,70,0,2,154,2,0
60872,443,25312,443,27204,15677,11527,59,62,30,29
63939,3389,63939,3389,4134,2109,2025,18,17,9,9
51183,445,0,0,70,70,0,1,0,1,0
50008,53,2633,53,232,94,138,2,29,1,1
54653,445,0,0,66,66,0,1,0,1,0
56004,53,60416,53,178,94,84,2,29,1,1
50474,80,43879,80,19357,10244,9113,36,27,19,17
49366,443,23124,443,14668,3601,11067,34,19,19,15
64407,445,0,0,70,70,0,1,0,1,0
62194,445,0,0,70,70,0,1,0,1,0
55360,80,13495,80,130,70,60,2,15,1,1
50585,80,50585,80,9588,4478,5110,28,21,16,12
60635,445,0,0,70,70,0,1,0,1,0
55849,53,21168,53,190,97,93,2,31,1,1
42298,40028,40095,40028,563,86,477,2,30,1,1
58638,5900,0,0,62,62,0,1,0,1,0
58247,445,0,0,66,66,0,1,0,1,0
59335,80,59335,80,107776,4213,103563,177,16,60,117
51413,1,0,0,72,72,0,1,0,1,0
34183,443,44472,443,10459,2529,7930,31,375,13,18
10390,26467,0,0,62,62,0,1,0,1,0
58860,443,58775,443,5594,3484,2110,16,15,8,8
21432,53,21432,53,244,98,146,2,32,1,1
26253,53,26253,53,414,268,146,3,33,2,1
50676,80,23134,80,13054,6885,6169,27,26,13,14
0,0,0,0,140,140,0,2,0,2,0
62071,22114,0,0,62,62,0,1,0,1,0
56206,53,48081,53,711,87,624,2,30,1,1
14036,48817,0,0,66,66,0,1,0,1,0
49164,443,45916,443,7292,950,6342,19,75,9,10
6882,6889,29221,6889,221,111,110,2,1201,1,1
58638,5900,0,0,62,62,0,1,0,1,0
51878,9999,7906,9999,66,66,0,1,5,1,0
54849,22448,0,0,66,66,0,1,90,1,0
37234,443,63563,443,1622,1137,485,11,26,7,4
64318,445,0,0,66,66,0,1,0,1,0
65420,53,11720,53,166,86,80,2,30,1,1
38758,23,0,0,60,60,0,1,0,1,0
47173,35440,0,0,146,146,0,1,0,1,0
42969,8146,0,0,62,62,0,1,0,1,0
59476,443,42006,443,4697,923,3774,13,120,6,7
51101,80,9411,80,366,240,126,7,20,5,2
51411,443,11555,443,202,70,132,3,11,1,2
51401,6881,0,0,66,66,0,1,0,1,0
61329,51505,0,0,66,66,0,1,0,1,0
51780,21130,9712,21130,70,70,0,2,8,2,0
32704,46824,0,0,66,66,0,1,0,1,0
65266,53,11513,53,754,94,660,2,30,1,1
45673,30188,0,0,62,62,0,1,0,1,0
51806,49530,42413,49530,66,66,0,1,5,1,0
33215,37965,0,0,62,62,0,1,0,1,0
64891,53,17816,53,211,102,109,2,30,1,1
56288,53,63412,53,210,110,100,2,30,1,1
42294,443,1257,443,10384,4353,6031,29,251,16,13
50586,443,6357,443,2756,1594,1162,20,27,11,9
54763,443,60297,443,7136,5777,1359,22,200,13,9
64728,443,31234,443,25423484,377367,25046117,21027,1082,2865,18162
65023,445,0,0,66,66,0,1,0,1,0
49482,80,49482,80,2444,1148,1296,14,48,7,7
55421,445,0,0,66,66,0,1,0,1,0
64435,445,0,0,70,70,0,1,0,1,0
40877,443,50860,443,6451,1003,5448,21,360,11,10
47322,80,21803,80,75931,3459,72472,97,43,38,59
50974,11392,0,0,66,66,0,1,0,1,0
49484,7000,49484,7000,2958,1567,1391,15,15,8,7
65167,445,0,0,70,70,0,1,0,1,0
61661,445,0,0,70,70,0,1,0,1,0
60261,53,9176,53,233,81,152,2,31,1,1
49352,443,51520,443,10055,1184,8871,21,76,9,12
56708,443,4344,443,8059,2039,6020,20,15,11,9
56399,53,36148,53,498,204,294,6,29,3,3
49418,22114,0,0,66,66,0,1,0,1,0
55018,53,37429,53,179,94,85,2,30,1,1
56380,53,5120,53,177,94,83,2,30,1,1
52930,443,25439,443,4596,1029,3567,15,26,9,6
38852,37965,0,0,62,62,0,1,0,1,0
49780,53,7446,53,182,93,89,2,31,1,1
44847,20101,53137,20101,150,150,0,1,1200,1,0
63012,443,56934,443,3707,1245,2462,11,119,6,5
57397,53,25863,53,182,93,89,2,31,1,1
42166,443,20816,443,5309,3110,2199,36,81,18,18
57007,53,38539,53,183,94,89,2,30,1,1
49418,27015,14381,27015,248,71,177,2,31,1,1
54166,445,0,0,70,70,0,1,0,1,0
56884,53,27069,53,177,94,83,2,30,1,1
64114,445,0,0,66,66,0,1,0,1,0
65067,53,28760,53,86,86,0,1,30,1,0
55877,27906,5770,27906,480,149,331,2,1200,1,1
49786,25174,0,0,66,66,0,1,0,1,0
60422,445,0,0,70,70,0,1,0,1,0
52531,445,0,0,66,66,0,1,0,1,0
59055,11392,0,0,66,66,0,1,0,1,0
18652,64147,0,0,62,62,0,1,0,1,0
65176,53,65083,53,183,94,89,2,30,1,1
63004,445,0,0,66,66,0,1,0,1,0
56196,445,0,0,66,66,0,1,0,1,0
56418,80,22380,80,39249,938,38311,40,104,11,29
49756,445,0,0,70,70,0,1,0,1,0
49450,53,29878,53,758,102,656,2,30,1,1
58890,15000,13228,15000,138,78,60,2,5,1,1
49861,445,0,0,70,70,0,1,0,1,0
52001,12514,13607,12514,66,66,0,1,5,1,0
52042,443,63896,443,8740,1799,6941,25,25,13,12
49901,53,59612,53,193,102,91,2,31,1,1
27005,27027,58259,27027,1654,126,1528,4,31,2,2
55487,53,40739,53,199,102,97,2,30,1,1
58864,443,14029,443,5167,700,4467,16,15,7,9
51729,63553,6792,63553,70,70,0,1,5,1,0
57148,23,0,0,60,60,0,1,0,1,0
55789,445,0,0,66,66,0,1,0,1,0
49945,445,0,0,70,70,0,1,0,1,0
60476,55100,21039,55100,70,70,0,2,8,2,0
53043,443,3283,443,11020,3760,7260,56,92,25,31
443,62451,0,0,199,199,0,1,0,1,0
443,22238,0,0,112,112,0,1,0,1,0
3478,61463,0,0,180,180,0,1,0,1,0
58701,445,0,0,70,70,0,1,0,1,0
49204,54530,41547,54530,316,136,180,6,6,3,3
55871,443,13590,443,21179,8150,13029,46,153,25,21
26504,443,26504,443,1251,722,529,11,147,6,5
63467,37807,0,0,62,62,0,1,0,1,0
63959,53,54075,53,246,102,144,2,31,1,1
65414,53,10727,53,197,102,95,2,31,1,1
18652,64147,0,0,62,62,0,1,0,1,0
63211,445,0,0,66,66,0,1,0,1,0
3578,51505,0,0,66,66,0,1,0,1,0
49305,445,0,0,70,70,0,1,0,1,0
1024,44847,0,0,62,62,0,1,0,1,0
49263,53,10892,53,731,85,646,2,31,1,1
46734,50265,0,0,74,74,0,1,0,1,0
49402,53,34826,53,214,110,104,2,30,1,1
65240,53,39958,53,199,94,105,2,30,1,1
59898,443,27640,443,1265,684,581,13,30,6,7
21447,53,55331,53,245648,213726,31922,2763,89,2579,184
60272,26467,0,0,66,66,0,1,0,1,0
65107,53,56824,53,266,87,179,4,32,2,2
36151,443,3051,443,22856,2980,19876,43,116,19,24
1025,50584,0,0,62,62,0,1,0,1,0
64888,60038,0,0,66,66,0,1,91,1,0
52837,445,0,0,66,66,0,1,0,1,0
65367,445,0,0,70,70,0,1,0,1,0
443,62732,0,0,332,332,0,1,0,1,0
19367,35440,0,0,146,146,0,1,0,1,0
60908,445,0,0,66,66,0,1,0,1,0
19610,55839,0,0,137,137,0,1,0,1,0
49668,443,23437,443,7978,2204,5774,20,58,10,10
49901,443,3004,443,4949,1047,3902,22,33,11,11
56998,53,18836,53,711,87,624,2,30,1,1
57134,445,0,0,70,70,0,1,0,1,0
60508,55998,14688,55998,70,70,0,2,8,2,0
64613,445,0,0,70,70,0,1,0,1,0
64667,53,24129,53,353,118,235,2,30,1,1
47969,53,59484,53,199,94,105,2,30,1,1
59400,22114,0,0,62,62,0,1,0,1,0
54188,6004,0,0,78,78,0,1,0,1,0
18001,35440,0,0,146,146,0,1,0,1,0
59402,445,0,0,70,70,0,1,0,1,0
62764,445,0,0,70,70,0,1,0,1,0
31675,19473,0,0,62,62,0,1,0,1,0
63330,445,0,0,66,66,0,1,0,1,0
60238,80,26979,80,1176,701,475,9,150,6,3
28385,50584,0,0,62,62,0,1,0,1,0
39818,443,44736,443,2211,1181,1030,23,40,11,12
52676,53733,0,0,62,62,0,1,0,1,0
56770,443,57005,443,124,64,60,2,16,1,1
64509,9571,0,0,62,62,0,1,0,1,0
55643,53,39402,53,182,93,89,2,0,1,1
51052,445,0,0,70,70,0,1,0,1,0
53770,64147,0,0,66,66,0,1,0,1,0
60557,23117,0,0,66,66,0,1,0,1,0
64357,445,0,0,70,70,0,1,0,1,0
52045,16853,65490,16853,70,70,0,2,8,2,0
19594,23117,0,0,62,62,0,1,0,1,0
28192,50584,0,0,66,66,0,1,0,1,0
52072,445,0,0,66,66,0,1,0,1,0
59938,443,3054,443,70,70,0,1,5,1,0
50818,445,0,0,70,70,0,1,0,1,0
63932,63241,5696,63241,436,254,182,7,15,4,3
61506,443,7741,443,15255,2304,12951,30,31,13,17
56138,53,1894,53,783,96,687,2,31,1,1
50313,445,0,0,70,70,0,1,0,1,0
52827,25174,0,0,62,62,0,1,0,1,0
60863,443,21124,443,24452,12758,11694,39,129,23,16
64316,53,46275,53,184,94,90,2,31,1,1
42298,40042,16142,40042,148,86,62,2,30,1,1
35291,44847,0,0,66,66,0,1,0,1,0
49936,53,50715,53,152,78,74,2,31,1,1
50944,445,0,0,70,70,0,1,0,1,0
56272,53,59359,53,167,86,81,2,31,1,1
57990,445,0,0,66,66,0,1,0,1,0
50589,80,50589,80,1714,1014,700,11,21,6,5
50416,80,7917,80,11343,3864,7479,22,21,11,11
56395,53,28310,53,177,94,83,2,30,1,1
443,52365,0,0,97,97,0,1,0,1,0
5462,21247,0,0,66,66,0,1,0,1,0
15503,21394,46725,21394,479,150,329,2,1200,1,1
32346,53,32346,53,194,87,107,2,30,1,1
14740,26467,0,0,62,62,0,1,0,1,0
49629,26467,0,0,66,66,0,1,0,1,0
56146,445,0,0,66,66,0,1,0,1,0
49291,53,35462,53,212,102,110,2,29,1,1
29011,7000,29011,7000,3756,2125,1631,18,17,10,8
46414,80,41611,80,1155,781,374,10,15,6,4
52556,443,21958,443,5696,2392,3304,23,135,10,13
62306,53,46053,53,387,94,293,2,30,1,1
49961,53,46234,53,216,110,106,2,31,1,1
61255,445,0,0,70,70,0,1,0,1,0
57775,445,0,0,70,70,0,1,0,1,0
64917,53,1366,53,243,94,149,2,30,1,1
62112,443,63604,443,4655,1649,3006,10,120,5,5
56659,53,34690,53,199,94,105,2,30,1,1
40242,443,42973,443,7407,2516,4891,37,32,19,18
54530,445,0,0,70,70,0,1,0,1,0
54518,7000,54518,7000,3518,1951,1567,15,15,8,7
38723,15503,0,0,146,146,0,1,0,1,0
38077,80,35599,80,1484,601,883,9,44,6,3
52346,445,0,0,66,66,0,1,0,1,0
50037,53,65320,53,195,102,93,2,31,1,1
20576,37965,0,0,62,62,0,1,0,1,0
4323,64147,0,0,62,62,0,1,0,1,0
53915,443,38797,443,7917,2410,5507,32,26,18,14
27005,1108,19358,1108,873,126,747,2,30,1,1
2332,35440,0,0,66,66,0,1,0,1,0
64332,53,56454,53,195,102,93,2,31,1,1
46219,53,46219,53,237,91,146,2,33,1,1
60555,445,0,0,70,70,0,1,0,1,0
22390,19473,0,0,66,66,0,1,0,1,0
1024,57470,0,0,62,62,0,1,0,1,0
49680,53,31932,53,749,94,655,2,30,1,1
58652,445,0,0,70,70,0,1,0,1,0
60052,37965,0,0,66,66,0,1,0,1,0
65441,80,26203,80,366,180,186,7,28,4,3
54526,44847,0,0,62,62,0,1,0,1,0
33825,443,12586,443,15400,12233,3167,75,995,38,37
28764,2323,0,0,60,60,0,1,0,1,0
53516,443,26441,443,560,280,280,9,34,5,4
50458,53,25707,53,177,94,83,2,30,1,1
56314,53,2805,53,182,93,89,2,30,1,1
35347,20238,0,0,66,66,0,1,0,1,0
55127,53,55127,53,220,100,120,2,31,1,1
49226,443,24983,443,532687,14365,518322,560,20,211,349
57015,42707,0,0,62,62,0,1,0,1,0
1114,46824,0,0,62,62,0,1,0,1,0
58638,5900,0,0,62,62,0,1,0,1,0
47595,33440,0,0,106,106,0,1,61,1,0
56938,53,41054,53,198,101,97,2,30,1,1
42574,443,64198,443,130,70,60,3,5,2,1
49890,53,63142,53,767,102,665,2,30,1,1
52611,9571,0,0,62,62,0,1,0,1,0
54712,443,60548,443,5158,2609,2549,11,121,6,5
50292,62413,0,0,62,62,0,1,0,1,0
56762,53,35908,53,168,86,82,2,31,1,1
57034,44847,0,0,66,66,0,1,0,1,0
55745,53,56029,53,199,102,97,2,30,1,1
48817,51413,48817,51413,485,158,327,2,1200,1,1
49984,53,22558,53,178,94,84,2,30,1,1
57901,443,18752,443,3924,1906,2018,26,170,14,12
64488,53,54282,53,356,98,258,4,35,2,2
55701,55777,0,0,62,62,0,1,0,1,0
49162,53,30620,53,401,94,307,4,32,2,2
51378,3027,51378,3027,156,156,0,3,8,3,0
49875,53,51820,53,399,86,313,4,49,2,2
65460,53,50952,53,215,102,113,2,29,1,1
49198,445,0,0,66,66,0,1,0,1,0
64995,53,14595,53,210,110,100,2,30,1,1
62618,445,0,0,66,66,0,1,0,1,0
54160,53,34866,53,199,94,105,2,29,1,1
51745,57470,0,0,62,62,0,1,0,1,0
65365,445,0,0,70,70,0,1,0,1,0
51881,443,23769,443,4418,1116,3302,17,30,10,7
50041,443,6754,443,17237,1717,15520,36,152,16,20
54743,443,47896,443,166136,7244,158892,202,149,76,126
52208,43890,0,0,66,66,0,1,0,1,0
55088,53,55518,53,193,102,91,2,30,1,1
54955,445,0,0,66,66,0,1,0,1,0
61603,445,0,0,70,70,0,1,0,1,0
51172,44847,0,0,66,66,0,1,0,1,0
50807,445,0,0,66,66,0,1,0,1,0
57143,53,34750,53,184,94,90,2,31,1,1
49418,31000,20791,31000,78,78,0,1,30,1,0
54973,53,3418,53,308,102,206,2,30,1,1
45345,443,9986,443,2438,1442,996,21,27,12,9
63872,445,0,0,70,70,0,1,0,1,0
65114,53,28927,53,196,102,94,2,30,1,1
56677,53,61027,53,200,102,98,2,30,1,1
54710,443,54710,443,32709,8467,24242,54,20,29,25
38852,37965,0,0,62,62,0,1,0,1,0
1024,64147,0,0,62,62,0,1,0,1,0
33060,443,63569,443,25617,6531,19086,87,220,46,41
4748,64147,0,0,66,66,0,1,0,1,0
54125,443,18046,443,170665,9296,161369,227,116,102,125
55156,53,48355,53,256,87,169,4,37,2,2
35657,48637,0,0,62,62,0,1,0,1,0
53641,16605,38186,16605,70,70,0,2,7,2,0
56268,44847,0,0,66,66,0,1,0,1,0
56636,80,30803,80,234,234,0,4,12,4,0
58562,57587,0,0,66,66,0,1,0,1,0
50837,443,12077,443,3292,2022,1270,16,16,9,7
60130,80,60130,80,23216,1806,21410,40,28,20,20
53725,64147,0,0,66,66,0,1,0,1,0
46475,80,46475,80,8300,966,7334,14,20,6,8
65284,53,18214,53,758,96,662,2,31,1,1
55725,445,0,0,66,66,0,1,0,1,0
48354,5222,3961,5222,7786,1403,6383,44,434,15,29
54325,445,0,0,66,66,0,1,0,1,0
50069,445,0,0,70,70,0,1,0,1,0
64811,51221,0,0,66,66,0,1,0,1,0
59112,443,3834,443,7174,1831,5343,31,110,17,14
51032,445,0,0,66,66,0,1,0,1,0
57243,53,28936,53,168,78,90,2,30,1,1
50375,53,45862,53,211,110,101,2,30,1,1
19270,56448,0,0,78,78,0,1,0,1,0
63569,62413,0,0,66,66,0,1,0,1,0
54932,445,0,0,70,70,0,1,0,1,0
55163,443,13789,443,2329,505,1824,14,124,7,7
56349,53,14775,53,184,102,82,2,29,1,1
60167,80,41576,80,6017,5209,808,12,30,7,5
5830,22114,0,0,66,66,0,1,0,1,0
60334,443,17024,443,7506,4789,2717,28,130,16,12
41858,53,0,0,86,86,0,1,30,1,0
65485,443,65115,443,92447,4519,87928,105,16,39,66
65171,53,52756,53,194,94,100,2,29,1,1
50681,445,0,0,66,66,0,1,0,1,0
49215,445,0,0,70,70,0,1,0,1,0
65439,445,0,0,70,70,0,1,0,1,0
58085,57470,0,0,62,62,0,1,0,1,0
55516,445,0,0,70,70,0,1,0,1,0
3377,50584,0,0,62,62,0,1,0,1,0
48817,63615,48817,63615,765,296,469,4,1200,2,2
65352,445,0,0,66,66,0,1,0,1,0
34112,44847,0,0,62,62,0,1,0,1,0
44455,443,5697,443,6972,1375,5597,20,31,10,10
36339,443,4245,443,7295,1830,5465,23,316,13,10
53803,17637,39254,17637,70,70,0,1,5,1,0
50614,443,33140,443,3499,1732,1767,15,16,9,6
24351,57470,0,0,62,62,0,1,0,1,0
54677,443,22432,443,10029,4115,5914,31,61,17,14
55043,57470,0,0,78,78,0,1,0,1,0
2077,7000,2077,7000,3054,1599,1455,16,15,8,8
36641,25174,0,0,66,66,0,1,0,1,0
65367,53,6408,53,251,94,157,2,30,1,1
63106,443,7897,443,8712,3748,4964,51,255,23,28
58773,443,53074,443,3854,2390,1464,17,15,8,9
11552,44847,0,0,62,62,0,1,0,1,0
11488,22114,0,0,66,66,0,1,0,1,0
50584,45270,4666,45270,1377,300,1077,6,1200,3,3
55828,53,3503,53,178,91,87,2,30,1,1
62787,51221,0,0,66,66,0,1,0,1,0
51090,445,0,0,70,70,0,1,0,1,0
50378,445,0,0,70,70,0,1,0,1,0
9294,443,62511,443,6356,979,5377,19,27,10,9
52418,46314,0,0,66,66,0,1,0,1,0
30960,45656,54549,45656,66,66,0,1,3600,1,0
51049,445,0,0,70,70,0,1,0,1,0
59844,445,0,0,70,70,0,1,0,1,0
60370,443,62763,443,6045,1834,4211,21,82,10,11
60438,53,64563,53,78,78,0,1,30,1,0
49573,80,24541,80,180917,5183,175734,175,65,49,126
52512,80,4200,80,10889,1117,9772,22,16,12,10
55912,445,0,0,70,70,0,1,0,1,0
52606,53,0,0,223,91,132,2,30,1,1
64243,53,51060,53,258,102,156,2,30,1,1
60006,443,38577,443,185169,75281,109888,426,111,209,217
49459,443,10186,443,10166,3392,6774,35,133,18,17
57302,445,0,0,66,66,0,1,0,1,0
49828,53,44800,53,733,86,647,2,29,1,1
58638,5900,0,0,62,62,0,1,0,1,0
49969,53,54536,53,356,105,251,4,49,2,2
54649,445,0,0,66,66,0,1,0,1,0
60450,56494,22867,56494,70,70,0,2,8,2,0
50934,80,52977,80,10213447,100765,10112682,8215,121,1412,6803
50985,445,0,0,66,66,0,1,0,1,0
32983,51221,0,0,66,66,0,1,0,1,0
58638,5900,0,0,62,62,0,1,0,1,0
36586,3142,36586,3142,138,78,60,2,6,1,1
49247,53,56867,53,478,196,282,6,63,3,3
55385,53,61909,53,710,89,621,2,0,1,1
55166,445,0,0,66,66,0,1,0,1,0
55735,50584,0,0,62,62,0,1,0,1,0
48676,53395,0,0,60,60,0,1,0,1,0
56928,53,56928,53,823,98,725,2,30,1,1
49490,53,6765,53,364,92,272,4,38,2,2
65018,53,21026,53,168,94,74,2,31,1,1
5385,22,5385,22,66,66,0,1,4,1,0
41230,443,13536,443,78,78,0,1,5,1,0
8432,23,8432,23,130,66,64,2,5,1,1
30181,61689,0,0,62,62,0,1,0,1,0
53207,50584,0,0,66,66,0,1,0,1,0
50553,443,23117,443,1632,1023,609,16,133,9,7
56712,53,57306,53,170,87,83,2,31,1,1
39681,37965,0,0,62,62,0,1,0,1,0
49917,53,47966,53,752,93,659,2,31,1,1
10006,64147,0,0,62,62,0,1,0,1,0
64700,53,51210,53,458,188,270,6,29,3,3
58791,15503,0,0,66,66,0,1,0,1,0
65471,443,32170,443,92569,4939,87630,111,15,45,66
49369,53,3787,53,182,93,89,2,31,1,1
64721,53,18309,53,214,110,104,2,30,1,1
62029,22114,0,0,66,66,0,1,0,1,0
49671,53,50695,53,335,117,218,4,36,2,2
53151,445,0,0,66,66,0,1,0,1,0
53807,28630,53835,28630,70,70,0,2,8,2,0
60900,445,0,0,66,66,0,1,0,1,0
27641,39004,0,0,62,62,0,1,0,1,0
56260,53,39887,53,170,87,83,2,31,1,1
45935,25,35960,25,511,191,320,9,60,4,5
3996,57470,0,0,62,62,0,1,0,1,0
53215,445,0,0,70,70,0,1,0,1,0
63750,63343,14942,63343,66,66,0,1,5,1,0
55532,80,8734,80,3367,2346,1021,19,39,11,8
53355,23117,0,0,62,62,0,1,0,1,0
50643,445,0,0,70,70,0,1,0,1,0
49699,53,17835,53,266,89,177,4,58,2,2
50789,445,0,0,70,70,0,1,0,1,0
38886,53,39118,53,223,78,145,2,30,1,1
28007,443,65025,443,10168,968,9200,19,15,9,10
51887,16514,28256,16514,70,70,0,1,5,1,0
58785,445,0,0,70,70,0,1,0,1,0
60782,20010,25511,20010,70,70,0,1,5,1,0
60311,56205,0,0,66,66,0,1,0,1,0
12939,53,12939,53,216,82,134,2,32,1,1
55911,445,0,0,70,70,0,1,0,1,0
49901,53,43057,53,752,93,659,2,31,1,1
56616,445,0,0,66,66,0,1,0,1,0
65352,53,63363,53,321,102,219,2,29,1,1
37939,80,33562,80,1616,1302,314,10,15,5,5
6729,51505,0,0,62,62,0,1,0,1,0
49748,443,24833,443,7084,1703,5381,19,128,10,9
43747,22114,0,0,62,62,0,1,0,1,0
50683,443,31278,443,12362,1650,10712,33,300,14,19
50994,445,0,0,66,66,0,1,0,1,0
58503,445,0,0,70,70,0,1,0,1,0
62232,80,62232,80,2158,1419,739,11,150,6,5
56206,445,0,0,70,70,0,1,0,1,0
3478,61463,0,0,164,164,0,1,0,1,0
56736,443,32910,443,7890,1901,5989,20,15,11,9
34344,443,5583,443,9167,2205,6962,37,120,19,18
65117,53,55253,53,542,100,442,4,51,2,2
13825,443,28678,443,8844,949,7895,19,75,9,10
45941,23386,0,0,60,60,0,1,0,1,0
51643,445,0,0,66,66,0,1,0,1,0
63261,445,0,0,70,70,0,1,0,1,0
10151,6881,61137,6881,469,150,319,2,1200,1,1
49385,53,7961,53,214,102,112,2,30,1,1
63978,53,35344,53,214,110,104,2,30,1,1
57269,53,41250,53,182,93,89,2,31,1,1
51956,443,47122,443,8256,3157,5099,28,46,16,12
33576,443,52498,443,170319,23354,146965,283,34,121,162
50699,443,40507,443,9382,3057,6325,35,1220,17,18
13581,51505,0,0,66,66,0,1,0,1,0
45939,443,45939,443,4504,1597,2907,19,27,11,8
58961,80,54182,80,1674,1360,314,11,15,6,5
55961,53,7584,53,214,102,112,2,30,1,1
53230,443,53230,443,1462,916,546,13,34,7,6
33045,443,23219,443,4446,1298,3148,15,34,8,7
50482,80,36252,80,314,192,122,6,25,4,2
55063,5223,9362,5223,4336,1518,2818,23,3002,14,9
55940,53,24862,53,168,86,82,2,30,1,1
64742,53,25271,53,165,86,79,2,29,1,1
40988,60043,0,0,146,146,0,1,0,1,0
56291,53,26835,53,177,94,83,2,30,1,1
51413,57470,0,0,72,72,0,1,0,1,0
38696,443,18796,443,1069542,21337,1048205,1028,16,310,718
35265,80,15083,80,3524,2698,826,14,16,8,6
50284,80,36535,80,8269,1423,6846,20,75,10,10
55130,445,0,0,70,70,0,1,0,1,0
58638,5900,0,0,62,62,0,1,0,1,0
41033,443,54265,443,4974,2311,2663,29,79,15,14
55844,443,40826,443,6881,2073,4808,37,255,18,19
37185,443,49991,443,14035,8420,5615,31,256,18,13
28013,443,29765,443,6130,1264,4866,18,75,9,9
57321,53,18718,53,199,102,97,2,30,1,1
63208,30975,0,0,148,148,0,1,0,1,0
58925,25174,0,0,66,66,0,1,0,1,0
57375,445,0,0,70,70,0,1,0,1,0
61948,445,0,0,66,66,0,1,0,1,0
63527,445,0,0,70,70,0,1,0,1,0
49582,53,29592,53,168,78,90,2,30,1,1
2383,37965,0,0,66,66,0,1,0,1,0
56380,36829,0,0,66,66,0,1,0,1,0
58710,445,0,0,66,66,0,1,0,1,0
60003,443,18889,443,32538,7037,25501,49,143,20,29
58038,51505,0,0,146,146,0,1,0,1,0
64724,443,50877,443,8602,1050,7552,16,121,7,9
23332,80,23332,80,490,264,226,8,26,5,3
46881,53,46881,53,197,90,107,2,30,1,1
61735,445,0,0,66,66,0,1,0,1,0
33084,443,45325,443,15474,4188,11286,14,139,4,10
55469,445,0,0,70,70,0,1,0,1,0
49539,53,64502,53,340,87,253,4,50,2,2
50949,45960,0,0,62,62,0,1,0,1,0
65000,445,0,0,66,66,0,1,0,1,0
65332,56205,0,0,62,62,0,1,0,1,0
51986,41982,32620,41982,70,70,0,1,5,1,0
65028,53,37363,53,79,79,0,2,33,2,0
25031,25174,0,0,62,62,0,1,0,1,0
51779,49525,24742,49525,70,70,0,2,8,2,0
56333,53,17825,53,199,102,97,2,30,1,1
43596,80,25616,80,1947,1182,765,10,515,6,4
55929,53,16714,53,760,97,663,2,30,1,1
41322,443,6156,443,994089,30018,964071,1058,350,373,685
50537,5223,31982,5223,12710,4688,8022,44,2961,19,25
53894,2944,4121,2944,70,70,0,2,8,2,0
50630,53,64139,53,209,110,99,2,30,1,1
63034,443,51705,443,37694,8319,29375,85,153,36,49
42338,443,46950,443,4181,998,3183,14,26,7,7
53922,443,26654,443,499,425,74,4,0,3,1
26601,22114,0,0,66,66,0,1,0,1,0
52098,445,0,0,70,70,0,1,0,1,0
52519,44847,0,0,66,66,0,1,0,1,0
59646,5223,55530,5223,70,70,0,1,5,1,0
56339,445,0,0,70,70,0,1,0,1,0
62924,993,52929,993,9376,4359,5017,86,19,44,42
49418,27017,15205,27017,252,78,174,2,30,1,1
57586,445,0,0,66,66,0,1,0,1,0
63832,25174,0,0,66,66,0,1,0,1,0
56330,53,48374,53,271,95,176,4,47,2,2
30599,46824,0,0,66,66,0,1,0,1,0
57395,53,40276,53,262,88,174,4,58,2,2
64458,53,4904,53,292,102,190,2,30,1,1
47207,443,60906,443,11085,2554,8531,48,19,24,24
52476,443,35367,443,7787,3056,4731,19,87,10,9
59757,53,47514,53,260,86,174,2,30,1,1
38566,443,54032,443,4108,1272,2836,11,121,5,6
61721,445,0,0,66,66,0,1,0,1,0
59887,445,0,0,70,70,0,1,0,1,0
51148,9571,0,0,66,66,0,1,0,1,0
54631,44847,0,0,74,74,0,1,0,1,0
55176,445,0,0,70,70,0,1,0,1,0
50324,445,0,0,70,70,0,1,0,1,0
9095,22114,0,0,62,62,0,1,0,1,0
62630,445,0,0,70,70,0,1,0,1,0
56415,80,5751,80,38339,808,37531,37,104,9,28
54390,445,0,0,70,70,0,1,0,1,0
51768,80,6690,80,211684,9903,201781,247,27,109,138
56701,443,57052,443,8007,1987,6020,20,15,11,9
50356,53,7944,53,176,90,86,2,31,1,1
39338,443,58557,443,4362,1145,3217,17,26,9,8
62930,21247,0,0,66,66,0,1,0,1,0
50428,80,50756,80,312,192,120,6,27,4,2
38676,443,23921,443,101056,3737,97319,107,15,35,72
49622,50584,0,0,62,62,0,1,0,1,0
49778,443,56574,443,10105,1951,8154,24,126,13,11
44246,5228,57956,5228,19678,4762,14916,98,9851,54,44
58248,445,0,0,70,70,0,1,0,1,0
55752,443,54224,443,11823,4029,7794,25,143,12,13
55071,53,30463,53,356,118,238,2,29,1,1
51457,443,49898,443,642,582,60,2,15,1,1
63197,445,0,0,66,66,0,1,0,1,0
64802,445,0,0,70,70,0,1,0,1,0
43391,80,44561,80,1560,684,876,10,15,5,5
49103,443,44063,443,6725,505,6220,20,181,5,15
32927,443,11670,443,5746,1079,4667,17,27,10,7
49491,443,28351,443,1627,884,743,12,27,6,6
51221,44710,11229,44710,481,150,331,2,1200,1,1
55707,53,50329,53,177,94,83,2,29,1,1
57265,53,15033,53,200,102,98,2,30,1,1
9544,7302,0,0,62,62,0,1,0,1,0
42044,60043,0,0,66,66,0,1,0,1,0
29577,64147,0,0,62,62,0,1,0,1,0
60678,445,0,0,66,66,0,1,0,1,0
65512,53,60205,53,744,95,649,2,31,1,1
52929,1433,0,0,60,60,0,1,0,1,0
64494,443,46008,443,2872,717,2155,14,135,6,8
64281,53,18314,53,212,108,104,2,30,1,1
50470,61463,0,0,86,86,0,1,0,1,0
25602,64147,0,0,62,62,0,1,0,1,0
54373,26467,0,0,62,62,0,1,0,1,0
6889,41864,0,0,143,143,0,1,0,1,0
58638,5900,0,0,62,62,0,1,0,1,0
57470,51413,16094,51413,700,275,425,4,1200,2,2
49480,443,58193,443,1160,638,522,13,113,7,6
56227,53,19451,53,194,102,92,2,30,1,1
57158,53,11939,53,969,86,883,2,30,1,1
61959,445,0,0,66,66,0,1,0,1,0
65068,23,0,0,60,60,0,1,0,1,0
52249,443,52249,443,152755,7304,145451,171,21,65,106
50538,80,28093,80,4314,3518,796,15,32,8,7
57396,53,65107,53,183,94,89,2,30,1,1
52459,33890,0,0,60,60,0,1,0,1,0
52497,47967,0,0,143,143,0,1,0,1,0
62412,445,0,0,70,70,0,1,0,1,0
44285,25174,0,0,146,146,0,1,0,1,0
63627,443,58785,443,17242,3015,14227,19,143,5,14
57425,443,33540,443,130,70,60,2,15,1,1
55921,443,55921,443,4510,1603,2907,19,27,11,8
54776,445,0,0,66,66,0,1,0,1,0
51314,445,0,0,66,66,0,1,0,1,0
55158,445,0,0,66,66,0,1,0,1,0
54695,445,0,0,70,70,0,1,0,1,0
1057,57470,0,0,62,62,0,1,0,1,0
49418,27018,53537,27018,256,78,178,2,30,1,1
50609,443,29620,443,1738,1061,677,18,94,10,8
58898,443,10940,443,5108,700,4408,15,15,7,8
48553,443,14731,443,49428,2702,46726,70,136,30,40
55019,53,16750,53,299,110,189,4,31,2,2
56594,53,16703,53,167,86,81,2,30,1,1
14059,21247,0,0,62,62,0,1,0,1,0
49520,443,49520,443,88797,5446,83351,137,76,70,67
49762,53,23081,53,760,97,663,2,30,1,1
52046,80,15183,80,27904,14100,13804,46,34,24,22
57439,445,0,0,66,66,0,1,0,1,0
58664,64147,0,0,62,62,0,1,0,1,0
49673,80,41313,80,318,192,126,6,41,4,2
56626,443,37778,443,45304,28614,16690,82,41,45,37
61467,443,56685,443,130792,4916,125876,161,89,69,92
58955,445,0,0,70,70,0,1,0,1,0
49580,53,21716,53,192,98,94,2,30,1,1
57385,53,56308,53,197,102,95,2,30,1,1
59622,445,0,0,70,70,0,1,0,1,0
59966,37965,0,0,66,66,0,1,0,1,0
55128,445,0,0,70,70,0,1,0,1,0
37759,53,22729,53,164,78,86,2,30,1,1
51667,80,5248,80,20457,4742,15715,37,139,20,17
50491,53,0,0,183,86,97,2,29,1,1
64038,28187,34899,28187,66,66,0,2,8,2,0
51984,54606,27351,54606,70,70,0,1,5,1,0
16862,21247,0,0,146,146,0,1,0,1,0
64402,445,0,0,66,66,0,1,0,1,0
52872,443,5601,443,110507,3940,106567,129,118,37,92
65189,27016,36079,27016,78,78,0,1,29,1,0
48301,25174,0,0,62,62,0,1,0,1,0
34990,80,31222,80,350,210,140,6,28,4,2
57129,445,0,0,70,70,0,1,0,1,0
59179,80,14130,80,1399,762,637,10,76,6,4
50869,80,23647,80,28291,3346,24945,46,144,25,21
56624,53,44653,53,199,102,97,2,30,1,1
52870,22197,0,0,66,66,0,1,0,1,0
64714,53,3550,53,168,86,82,2,31,1,1
59755,53,7532,53,211,78,133,2,30,1,1
65354,445,0,0,70,70,0,1,0,1,0
63702,445,0,0,70,70,0,1,0,1,0
52034,48856,21980,48856,70,70,0,2,9,2,0
63901,445,0,0,70,70,0,1,0,1,0
48676,53395,0,0,60,60,0,1,0,1,0
57470,53756,4202,53756,132,132,0,3,1199,3,0
60247,445,0,0,70,70,0,1,0,1,0
57810,80,62948,80,104397,8436,95961,122,21,49,73
52637,445,0,0,70,70,0,1,0,1,0
27005,27018,60808,27018,881,126,755,2,31,1,1
52064,80,33091,80,692,300,392,9,25,6,3
48706,23393,0,0,60,60,0,1,0,1,0
6881,12676,29408,12676,509,150,359,2,1199,1,1
62466,53,62466,53,194,87,107,2,30,1,1
55435,25174,0,0,146,146,0,1,0,1,0
56835,35894,0,0,66,66,0,1,0,1,0
54950,443,18760,443,5281,1393,3888,22,16,13,9
64655,443,35493,443,8903,2857,6046,22,135,10,12
51413,1,0,0,72,72,0,1,0,1,0
2946,25174,0,0,62,62,0,1,0,1,0
53798,62166,25360,62166,164,70,94,2,4,1,1
39890,123,28941,123,184,94,90,2,30,1,1
57470,43576,31912,43576,545,166,379,2,1200,1,1
49260,80,56058,80,2013987,64000,1949987,1818,160,504,1314
56842,24233,12414,24233,70,70,0,2,8,2,0
62029,22114,0,0,66,66,0,1,0,1,0
64946,53,45329,53,210,102,108,2,30,1,1
63074,445,0,0,70,70,0,1,0,1,0
64476,445,0,0,70,70,0,1,0,1,0
64787,53,24820,53,740,93,647,2,31,1,1
53630,445,0,0,70,70,0,1,0,1,0
50163,445,0,0,70,70,0,1,0,1,0
49759,53,4425,53,381,110,271,4,32,2,2
57470,45340,41159,45340,527,166,361,2,1200,1,1
41321,443,40754,443,6989232,188564,6800668,7110,288,2412,4698
45042,443,17332,443,8445,2120,6325,27,107,15,12
54717,445,0,0,70,70,0,1,0,1,0
55875,53,25979,53,296,110,186,2,30,1,1
56847,53,58381,53,252,102,150,2,30,1,1
50584,61867,27152,61867,166,166,0,1,1200,1,0
52962,445,0,0,70,70,0,1,0,1,0
6881,6881,0,0,146,146,0,1,0,1,0
29576,37807,0,0,66,66,0,1,0,1,0
62345,443,13195,443,6343025,74037,6268988,5018,58,765,4253
51487,443,18707,443,10453,3977,6476,27,54,15,12
49520,445,0,0,70,70,0,1,0,1,0
42922,80,41285,80,234,234,0,4,12,4,0
49919,443,15575,443,16012,2097,13915,33,16,15,18
64992,53,64992,53,180,82,98,2,30,1,1
16814,53,16814,53,217,87,130,2,30,1,1
52434,80,48898,80,1647,481,1166,13,15,6,7
57970,445,0,0,66,66,0,1,0,1,0
52182,443,4685,443,237151,13019,224132,251,42,90,161
55072,53,31850,53,168,86,82,2,31,1,1
58091,51505,0,0,66,66,0,1,0,1,0
49499,443,5486,443,8848,4908,3940,23,42,12,11
9445,56205,0,0,66,66,0,1,0,1,0
16387,7205,0,0,60,60,0,1,0,1,0
63938,53,63032,53,385,110,275,2,30,1,1
37297,443,18068,443,4514,1928,2586,17,240,8,9
65534,53,65534,53,414,268,146,3,31,2,1
61700,53,61700,53,221,90,131,2,30,1,1
61912,17546,0,0,62,62,0,1,0,1,0
55858,53,14376,53,214,102,112,2,30,1,1
59915,445,0,0,70,70,0,1,0,1,0
49901,53,49901,53,194,87,107,2,30,1,1
52862,80,51424,80,3150,1478,1672,32,131,17,15
58101,46314,0,0,72,72,0,1,0,1,0
47088,15000,21651,15000,138,78,60,2,6,1,1
13285,29892,0,0,145,145,0,1,0,1,0
61591,445,0,0,66,66,0,1,0,1,0
56784,23140,27615,23140,70,70,0,1,5,1,0
47894,443,25578,443,52038,3333,48705,74,157,30,44
55630,53,39473,53,197,102,95,2,30,1,1
51120,445,0,0,66,66,0,1,0,1,0
50207,53,12070,53,189,102,87,2,31,1,1
39941,2767,0,0,62,62,0,1,0,1,0
33570,443,59571,443,81954,13611,68343,174,34,79,95
56362,53,52775,53,453,186,267,6,30,3,3
60720,23718,0,0,62,62,0,1,0,1,0
60179,445,0,0,66,66,0,1,0,1,0
55994,22114,0,0,66,66,0,1,0,1,0
60377,65054,58961,65054,624,318,306,10,15,5,5
62558,445,0,0,66,66,0,1,0,1,0
58151,445,0,0,70,70,0,1,0,1,0
36738,123,0,0,234,234,0,1,0,1,0
46299,443,43257,443,648083,28117,619966,751,30,323,428
42298,40029,57945,40029,652,83,569,4,31,2,2
56724,53,52473,53,195,102,93,2,30,1,1
50031,53,53719,53,178,91,87,2,31,1,1
47166,15000,45851,15000,130,70,60,2,5,1,1
52041,48103,59658,48103,70,70,0,1,5,1,0
58013,445,0,0,70,70,0,1,0,1,0
55695,53,64745,53,177,94,83,2,29,1,1
55192,53,5787,53,178,94,84,2,31,1,1
49842,443,3993,443,6212,1823,4389,16,75,9,7
51100,443,10929,443,9429,1978,7451,27,46,14,13
59570,443,28825,443,24203,14278,9925,168,320,74,94
11228,23,0,0,60,60,0,1,0,1,0
65418,53,5528,53,197,94,103,2,30,1,1
61741,445,0,0,70,70,0,1,0,1,0
59290,445,0,0,66,66,0,1,0,1,0
52773,443,22036,443,19594,11977,7617,48,100,25,23
63968,53,61368,53,310,142,168,2,30,1,1
64664,53,51475,53,168,86,82,2,34,1,1
55070,445,0,0,66,66,0,1,0,1,0
57880,445,0,0,70,70,0,1,0,1,0
55441,53,20150,53,216,110,106,2,31,1,1
53444,443,53444,443,960,539,421,9,30,5,4
56589,53,53742,53,711,87,624,2,30,1,1
59957,445,0,0,70,70,0,1,0,1,0
52662,445,0,0,70,70,0,1,0,1,0
29742,50584,0,0,62,62,0,1,0,1,0
61938,443,14944,443,7118,2462,4656,18,75,10,8
52765,445,0,0,70,70,0,1,0,1,0
26900,27017,57216,27017,422,164,258,6,30,3,3
50723,445,0,0,66,66,0,1,0,1,0
26900,27017,57594,27017,172,86,86,2,30,1,1
56963,53,26493,53,210,110,100,2,30,1,1
53772,14132,42222,14132,70,70,0,1,5,1,0
50299,445,0,0,70,70,0,1,0,1,0
55600,445,0,0,66,66,0,1,0,1,0
58807,445,0,0,66,66,0,1,0,1,0
40254,443,35283,443,7646,1024,6622,19,15,11,8
2995,26467,0,0,62,62,0,1,0,1,0
45455,443,59423,443,17237,2632,14605,34,420,18,16
54140,43890,0,0,66,66,0,1,0,1,0
55560,53,43077,53,166,86,80,2,30,1,1
36146,443,34524,443,1147,660,487,11,17,7,4
16013,35253,0,0,66,66,0,1,0,1,0
57867,27019,40046,27019,2338,634,1704,10,30,6,4
63407,445,0,0,70,70,0,1,0,1,0
50082,53,51299,53,199,94,105,2,30,1,1
25150,25174,0,0,62,62,0,1,0,1,0
39051,443,15445,443,7082,4527,2555,31,31,16,15
55884,53,23694,53,438,180,258,6,30,3,3
29697,51221,0,0,62,62,0,1,0,1,0
9467,443,18809,443,5960,438,5522,16,15,6,10
2089,7000,2089,7000,2227,676,1551,15,14,7,8
50127,64147,0,0,66,66,0,1,0,1,0
58856,443,29128,443,2881,1766,1115,17,16,9,8
56365,53,8027,53,199,102,97,2,30,1,1
57629,80,39284,80,1115,534,581,12,16,7,5
62766,445,0,0,70,70,0,1,0,1,0
27869,51221,0,0,66,66,0,1,0,1,0
56226,53,44944,53,284,96,188,4,33,2,2
50265,21544,58613,21544,390,266,124,6,1200,4,2
63427,445,0,0,70,70,0,1,0,1,0
41852,35440,0,0,62,62,0,1,0,1,0
65330,445,0,0,70,70,0,1,0,1,0
52488,443,19422,443,7165,1099,6066,16,18,9,7
63644,445,0,0,66,66,0,1,0,1,0
57987,3478,44464,3478,312,140,172,4,30,2,2
64538,53,37074,53,194,102,92,2,30,1,1
50859,445,0,0,66,66,0,1,0,1,0
53931,445,0,0,66,66,0,1,0,1,0
55036,53,7624,53,177,94,83,2,30,1,1
57239,53,64762,53,193,102,91,2,31,1,1
60646,445,0,0,70,70,0,1,0,1,0
58638,5900,0,0,62,62,0,1,0,1,0
49312,53,2239,53,184,86,98,2,30,1,1
50237,53,33615,53,183,94,89,2,30,1,1
56484,53,39719,53,214,110,104,2,30,1,1
65041,445,0,0,70,70,0,1,0,1,0
60714,50584,0,0,66,66,0,1,0,1,0
50953,445,0,0,66,66,0,1,0,1,0
55276,445,0,0,70,70,0,1,0,1,0
64135,445,0,0,70,70,0,1,0,1,0
57820,32753,0,0,361,361,0,1,0,1,0
1873,37965,0,0,62,62,0,1,0,1,0
50405,8080,50405,8080,3985,2010,1975,17,51,10,7
45897,443,62629,443,2267946,70852,2197094,2429,316,859,1570
443,60746,0,0,60,60,0,1,90,1,0
65256,53,29045,53,357,105,252,4,57,2,2
49369,53,34405,53,324,86,238,4,47,2,2
55317,443,24510,443,5692,1239,4453,23,16,13,10
54124,80,4965,80,1594,1280,314,10,15,5,5
65288,44847,0,0,66,66,0,1,0,1,0
1054,57470,0,0,62,62,0,1,0,1,0
15249,22114,0,0,62,62,0,1,0,1,0
24606,55783,0,0,72,72,0,1,0,1,0
61502,445,0,0,66,66,0,1,0,1,0
51727,445,0,0,66,66,0,1,0,1,0
49366,445,0,0,70,70,0,1,0,1,0
63085,53,50123,53,448,166,282,2,30,1,1
34465,443,9083,443,1402,910,492,11,360,6,5
29126,7000,29126,7000,4124,2423,1701,20,16,11,9
52245,445,0,0,66,66,0,1,0,1,0
59871,445,0,0,66,66,0,1,0,1,0
53106,445,0,0,70,70,0,1,0,1,0
55069,53,19618,53,195,102,93,2,31,1,1
52629,445,0,0,66,66,0,1,0,1,0
44300,443,36814,443,7746,2015,5731,29,15,16,13
58528,445,0,0,70,70,0,1,0,1,0
50428,443,32117,443,9844,4554,5290,24,92,13,11
53089,24211,0,0,62,62,0,1,0,1,0
56948,445,0,0,66,66,0,1,0,1,0
50388,53,14304,53,177,94,83,2,29,1,1
55032,5222,63875,5222,138,64,74,3,5,2,1
63295,445,0,0,70,70,0,1,0,1,0
63996,443,19057,443,122293139,3727246,118565893,125460,331,39649,85811
59528,445,0,0,66,66,0,1,0,1,0
46671,53,46671,53,832,106,726,2,30,1,1
50034,53,9396,53,174,89,85,2,30,1,1
56324,53,56324,53,257,101,156,2,34,1,1
49497,443,3660,443,8816,4876,3940,23,31,12,11
64588,443,57526,443,9156,2109,7047,27,32,15,12
60355,445,0,0,70,70,0,1,0,1,0
52905,445,0,0,66,66,0,1,0,1,0
0,0,0,0,98,98,0,1,0,1,0
43757,3389,43757,3389,3910,1805,2105,20,18,12,8
63582,443,11318,443,6178,1669,4509,19,15,11,8
16660,55783,0,0,62,62,0,1,0,1,0
5617,64147,0,0,145,145,0,1,0,1,0
65520,53,2299,53,379,94,285,2,30,1,1
52976,445,0,0,70,70,0,1,0,1,0
51745,2572,13644,2572,70,70,0,2,8,2,0
60222,443,18964,443,4308,1658,2650,14,16,7,7
64983,53,5979,53,181,94,87,2,30,1,1
49476,445,0,0,70,70,0,1,0,1,0
53895,443,14973,443,390740,13639,377101,441,132,152,289
20544,5223,0,0,148,148,0,1,0,1,0
49713,53,20450,53,821,102,719,2,30,1,1
62810,445,0,0,70,70,0,1,0,1,0
10354,81,0,0,60,60,0,1,0,1,0
44206,53,19423,53,202,83,119,2,30,1,1
56697,443,50660,443,3593,2749,844,18,22,11,7
62231,445,0,0,70,70,0,1,0,1,0
55199,53,62068,53,152,78,74,2,30,1,1
54063,445,0,0,70,70,0,1,0,1,0
5223,34403,0,0,220,220,0,1,0,1,0
55216,443,23383,443,8058,5498,2560,20,120,11,9
50979,445,0,0,70,70,0,1,0,1,0
1537,22114,0,0,62,62,0,1,0,1,0
53637,445,0,0,70,70,0,1,0,1,0
58169,445,0,0,70,70,0,1,0,1,0
46590,443,20776,443,6665,1130,5535,24,287,13,11
50031,44847,0,0,74,74,0,1,0,1,0
43677,443,54935,443,30090,19982,10108,77,543,41,36
49936,53,28353,53,211,102,109,2,31,1,1
63985,43081,52828,43081,70,70,0,1,5,1,0
65317,51221,0,0,78,78,0,1,0,1,0
52352,445,0,0,70,70,0,1,0,1,0
3597,11392,0,0,66,66,0,1,0,1,0
60714,445,0,0,66,66,0,1,0,1,0
24160,37807,0,0,62,62,0,1,0,1,0
34489,35440,0,0,66,66,0,1,0,1,0
61962,53733,0,0,66,66,0,1,0,1,0
55605,53,56113,53,196,100,96,2,30,1,1
53793,20468,60935,20468,70,70,0,2,8,2,0
42767,443,1762,443,8995,2498,6497,40,256,19,21
43482,443,29764,443,2316,1280,1036,20,278,11,9
42252,33306,0,0,60,60,0,1,0,1,0
50475,53,26369,53,772,100,672,2,31,1,1
65073,53,55415,53,325,102,223,2,29,1,1
58549,445,0,0,70,70,0,1,0,1,0
55639,62954,47207,62954,504,318,186,8,15,5,3
56963,80,25455,80,6974,3906,3068,19,30,11,8
62331,61689,0,0,62,62,0,1,0,1,0
64942,445,0,0,70,70,0,1,0,1,0
61399,445,0,0,70,70,0,1,0,1,0
59717,443,16330,443,303966,26201,277765,521,167,208,313
443,61686,0,0,90,90,0,1,0,1,0
56511,445,0,0,66,66,0,1,0,1,0
57470,23848,47855,23848,545,166,379,2,1199,1,1
55133,53,55133,53,228,90,138,2,30,1,1
1484,22114,0,0,146,146,0,1,0,1,0
56911,53,31733,53,177,94,83,2,30,1,1
58638,5900,0,0,62,62,0,1,0,1,0
52866,80,44619,80,6022,2590,3432,37,131,20,17
51413,443,55199,443,695,575,120,4,6,2,2
56897,7003,14885,7003,1098,672,426,14,734,8,6
56249,55442,0,0,66,66,0,1,0,1,0
55776,53,13718,53,182,93,89,3,33,2,1
55582,26957,64555,26957,70,70,0,1,5,1,0
27005,30000,27515,30000,913,126,787,2,31,1,1
39762,123,46956,123,184,94,90,2,30,1,1
59148,445,0,0,66,66,0,1,0,1,0
65307,53,63090,53,184,94,90,2,30,1,1
60401,80,25195,80,190,64,126,4,103,2,2
54762,53,0,0,86,86,0,1,30,1,0
49875,443,6451,443,31715,20427,11288,103,54,54,49
60557,23117,0,0,62,62,0,1,0,1,0
51017,80,29159,80,2654,796,1858,12,18,7,5
39743,80,10677,80,1563,570,993,10,16,6,4
49870,443,21099,443,6062,1042,5020,20,55,11,9
64557,445,0,0,70,70,0,1,0,1,0
11410,36237,0,0,146,146,0,1,0,1,0
52330,445,0,0,70,70,0,1,0,1,0
49577,445,0,0,70,70,0,1,0,1,0
56939,53,27310,53,216,110,106,2,30,1,1
59032,25174,0,0,66,66,0,1,0,1,0
55693,45341,14771,45341,70,70,0,2,8,2,0
9916,53,9916,53,235,90,145,2,33,1,1
62737,443,7478,443,35936,2741,33195,62,15,30,32
55834,53,38945,53,184,94,90,2,31,1,1
27005,27017,29678,27017,917,126,791,2,30,1,1
55325,53,11184,53,210,110,100,2,31,1,1
58013,80,34784,80,3877,2069,1808,15,26,9,6
63638,53,10182,53,286,78,208,2,30,1,1
53253,443,36100,443,8662,1469,7193,28,66,15,13
443,18177,0,0,66,66,0,1,0,1,0
54339,443,11466,443,3149,769,2380,10,120,5,5
34391,443,18031,443,80160,3527,76633,98,76,38,60
44847,17977,12872,17977,502,150,352,2,1200,1,1
50050,443,8381,443,7912,3269,4643,23,95,12,11
55985,53,19393,53,738,86,652,2,30,1,1
52926,443,36627,443,5458,1390,4068,17,15,9,8
37965,58609,35622,58609,15544,7978,7566,132,3153,72,60
38060,443,63699,443,27679,15839,11840,75,103,39,36
60883,443,43627,443,5710,1228,4482,21,16,12,9
65506,53,20953,53,197,102,95,2,30,1,1
56127,37965,0,0,66,66,0,1,0,1,0
46014,443,8499,443,13661,2246,11415,28,256,14,14
7347,56205,0,0,66,66,0,1,0,1,0
55312,53,24613,53,195,102,93,2,30,1,1
55406,25174,0,0,66,66,0,1,0,1,0
55899,57470,0,0,78,78,0,1,0,1,0
53739,443,35645,443,499,425,74,4,0,3,1
60116,445,0,0,70,70,0,1,0,1,0
59952,445,0,0,70,70,0,1,0,1,0
50367,37965,0,0,66,66,0,1,0,1,0
65111,443,62828,443,3255,1259,1996,13,135,7,6
50261,443,64119,443,10320,3495,6825,45,136,25,20
53784,16671,49140,16671,70,70,0,2,7,2,0
44414,123,11306,123,184,94,90,2,30,1,1
55855,445,0,0,70,70,0,1,0,1,0
60861,445,0,0,66,66,0,1,0,1,0
56713,53,30137,53,226,110,116,2,30,1,1
19004,51505,0,0,66,66,0,1,0,1,0
48692,57470,0,0,62,62,0,1,0,1,0
18745,64147,0,0,66,66,0,1,0,1,0
57094,53,10369,53,196,102,94,2,30,1,1
50333,80,53972,80,442,250,192,8,47,5,3
54365,445,0,0,70,70,0,1,0,1,0
58486,57470,0,0,66,66,0,1,0,1,0
51955,39871,23023,39871,70,70,0,2,8,2,0
57405,443,36790,443,5734,1543,4191,24,26,13,11
49369,53,21146,53,183,94,89,2,30,1,1
58638,5900,0,0,62,62,0,1,0,1,0
50563,445,0,0,70,70,0,1,0,1,0
62618,445,0,0,70,70,0,1,0,1,0
65056,53,43061,53,211,102,109,2,30,1,1
53063,445,0,0,70,70,0,1,0,1,0
51726,64147,0,0,66,66,0,1,0,1,0
58846,443,58496,443,7680,4905,2775,24,17,12,12
60780,28080,29726,28080,70,70,0,2,8,2,0
57131,35776,0,0,145,145,0,1,0,1,0
63956,38211,0,0,62,62,0,1,0,1,0
45766,35440,0,0,62,62,0,1,0,1,0
57109,443,58630,443,7170,1436,5734,35,261,19,16
14694,53,14694,53,230,90,140,2,30,1,1
58638,5900,0,0,62,62,0,1,0,1,0
59830,445,0,0,70,70,0,1,0,1,0
52070,443,55434,443,8971,4228,4743,20,95,12,8
63388,445,0,0,66,66,0,1,0,1,0
55285,53,18984,53,268,95,173,4,46,2,2
61017,64147,0,0,66,66,0,1,0,1,0
42252,33303,0,0,60,60,0,1,0,1,0
58901,443,24407,443,17071,1532,15539,17,27,3,14
443,61686,0,0,1484,1484,0,1,0,1,0
123,123,55557,123,184,94,90,2,29,1,1
65510,443,47071,443,92101,4799,87302,107,16,43,64
37307,443,33957,443,9563,2336,7227,25,15,14,11
54559,445,0,0,70,70,0,1,0,1,0
49974,445,0,0,70,70,0,1,0,1,0
56564,9571,0,0,78,78,0,1,0,1,0
59805,443,46522,443,2334,1113,1221,19,27,9,10
52458,53,52458,53,231,88,143,2,33,1,1
55540,53,5728,53,757,98,659,2,31,1,1
64729,445,0,0,66,66,0,1,0,1,0
64000,53,28661,53,241,102,139,2,30,1,1
3478,61463,0,0,804,804,0,1,0,1,0
55872,53,55193,53,819,102,717,2,30,1,1
63313,445,0,0,70,70,0,1,0,1,0
63032,22114,0,0,66,66,0,1,0,1,0
64875,53,51837,53,211,102,109,2,30,1,1
9316,443,33323,443,3649,424,3225,12,15,6,6
59346,445,0,0,70,70,0,1,0,1,0
65516,445,0,0,70,70,0,1,0,1,0
50727,57470,0,0,78,78,0,1,0,1,0
54355,443,13555,443,15334,4707,10627,28,24,14,14
57324,445,0,0,70,70,0,1,0,1,0
55536,445,0,0,70,70,0,1,0,1,0
55127,80,31027,80,4239,2334,1905,17,187,10,7
65466,53,9762,53,298,102,196,4,39,2,2
54539,445,0,0,66,66,0,1,0,1,0
1903,43890,0,0,62,62,0,1,0,1,0
63343,53,0,0,74,74,0,1,0,1,0
62060,445,0,0,70,70,0,1,0,1,0
59507,445,0,0,70,70,0,1,0,1,0
57536,53,46039,53,199,94,105,2,30,1,1
53109,80,20052,80,8176,1443,6733,20,15,10,10
49418,27015,20814,27015,249,78,171,2,30,1,1
51815,51221,0,0,74,74,0,1,0,1,0
32934,443,9755,443,7623,3362,4261,26,31,14,12
51865,61689,0,0,66,66,0,1,0,1,0
54293,445,0,0,70,70,0,1,0,1,0
54142,7000,54142,7000,4067,1750,2317,16,16,9,7
52095,443,20736,443,325846,10609,315237,326,38,106,220
59733,443,53510,443,7165,2077,5088,22,105,12,10
60045,445,0,0,70,70,0,1,0,1,0
57376,445,0,0,66,66,0,1,0,1,0
63569,62413,0,0,62,62,0,1,0,1,0
52860,9694,0,0,62,62,0,1,0,1,0
25009,35440,0,0,66,66,0,1,0,1,0
27038,51505,0,0,62,62,0,1,0,1,0
27005,27017,40940,27017,600,126,474,2,31,1,1
54079,443,34399,443,6931,1974,4957,24,342,11,13
60881,443,30566,443,8284,1577,6707,29,48,14,15
49864,53,49733,53,193,102,91,2,29,1,1
45350,443,10693,443,918,358,560,14,40,6,8
52238,26467,0,0,62,62,0,1,0,1,0
65482,53,46055,53,179,94,85,2,31,1,1
48020,53,48020,53,404,259,145,3,33,2,1
50466,445,0,0,66,66,0,1,0,1,0
37917,443,55165,443,6124,860,5264,18,361,9,9
65530,53,42402,53,194,102,92,2,30,1,1
49928,443,36059,443,11646,4774,6872,29,32,18,11
63877,51413,26586,51413,564,382,182,9,18,6,3
45908,33330,0,0,60,60,0,1,0,1,0
51996,57470,0,0,66,66,0,1,0,1,0
45079,31573,0,0,66,66,0,1,0,1,0
57023,443,30630,443,10514,2031,8483,28,149,12,16
56387,53,17582,53,183,94,89,2,30,1,1
54373,26467,0,0,62,62,0,1,0,1,0
60740,80,7735,80,254,128,126,5,16,3,2
59171,445,0,0,66,66,0,1,0,1,0
59696,445,0,0,70,70,0,1,0,1,0
55895,445,0,0,70,70,0,1,0,1,0
57390,445,0,0,70,70,0,1,0,1,0
55077,53,1629,53,174,89,85,2,31,1,1
61586,445,0,0,70,70,0,1,0,1,0
62972,445,0,0,66,66,0,1,0,1,0
64299,53,26079,53,268,84,184,4,42,2,2
17676,23,0,0,60,60,0,1,0,1,0
63925,53,47553,53,388,134,254,2,30,1,1
58891,445,0,0,70,70,0,1,0,1,0
52780,443,29664,443,122,62,60,2,15,1,1
49509,443,14742,443,17660,7465,10195,44,201,23,21
65179,53,9786,53,289,102,187,2,30,1,1
50868,80,40174,80,12388,742,11646,18,130,7,11
55306,53,39881,53,177,94,83,2,30,1,1
54666,36237,0,0,62,62,0,1,0,1,0
63968,53,62729,53,200,102,98,2,30,1,1
27005,27016,48371,27016,887,126,761,2,30,1,1
51819,59208,18687,59208,66,66,0,2,8,2,0
50439,443,55602,443,73712,18850,54862,135,717,61,74
60899,443,59717,443,847673,42767,804906,1045,89,441,604
14374,443,14374,443,1582,883,699,18,32,10,8
60686,445,0,0,70,70,0,1,0,1,0
48817,42099,48817,42099,479,152,327,2,1200,1,1
65265,55067,0,0,66,66,0,1,0,1,0
61116,445,0,0,70,70,0,1,0,1,0
33317,53,33317,53,231,88,143,2,32,1,1
56736,80,11534,80,194,128,66,4,25,3,1
49781,443,43148,443,7877,1949,5928,24,126,12,12
49537,53,25046,53,269,96,173,4,59,2,2
38692,443,1550,443,1188751,17817,1170934,1053,16,255,798
55165,53,30043,53,199,102,97,2,30,1,1
64073,445,0,0,70,70,0,1,0,1,0
57174,57470,0,0,66,66,0,1,0,1,0
48817,21939,48817,21939,513,152,361,2,1200,1,1
21133,8535,17822,8535,490,149,341,2,1200,1,1
54305,26467,0,0,66,66,0,1,0,1,0
54982,53,58418,53,282,96,186,4,47,2,2
3478,61463,0,0,1188,1188,0,1,0,1,0
59374,445,0,0,70,70,0,1,0,1,0
7701,80,7701,80,900,519,381,7,141,4,3
55699,21063,32423,21063,70,70,0,2,8,2,0
49741,53,12587,53,211,102,109,2,30,1,1
51326,443,48019,443,6250,1422,4828,20,17,10,10
6881,6881,0,0,146,146,0,1,0,1,0
56984,53,44033,53,209,102,107,2,30,1,1
53732,443,58255,443,499,425,74,4,0,3,1
51975,443,30656,443,4692,2376,2316,30,47,16,14
55735,53,13880,53,198,101,97,2,31,1,1
51823,80,56758,80,4456,1889,2567,11,39,6,5
59227,11392,0,0,62,62,0,1,0,1,0
53591,445,0,0,70,70,0,1,0,1,0
57140,53,49557,53,177,94,83,2,30,1,1
55643,53,52917,53,183,94,89,2,31,1,1
64650,53,46185,53,257,126,131,2,30,1,1
50334,80,53374,80,442,250,192,8,47,5,3
16387,57833,0,0,60,60,0,1,60,1,0
55155,445,0,0,70,70,0,1,0,1,0
60471,19776,4815,19776,70,70,0,1,5,1,0
51031,445,0,0,70,70,0,1,0,1,0
56439,53,38034,53,196,100,96,2,31,1,1
49702,80,20428,80,2014,1216,798,13,130,8,5
44883,53,44883,53,216,90,126,2,29,1,1
35785,80,12900,80,1594,1280,314,10,15,5,5
45720,443,24721,443,1625,1038,587,14,26,8,6
57339,443,64003,443,1778020,204978,1573042,2589,987,1006,1583
43103,443,44934,443,3149,1899,1250,19,15,9,10
8836,53,8836,53,203,82,121,2,30,1,1
56033,443,32455,443,3250,1058,2192,13,136,6,7
51809,52528,62433,52528,70,70,0,2,8,2,0
49718,445,0,0,66,66,0,1,0,1,0
55018,53,31411,53,174,89,85,2,30,1,1
63967,53,22995,53,195,102,93,2,33,1,1
55420,53,27651,53,177,94,83,2,29,1,1
62729,51558,61898,51558,70,70,0,1,4,1,0
61827,445,0,0,70,70,0,1,0,1,0
62150,23718,0,0,66,66,0,1,0,1,0
51582,48817,0,0,66,66,0,1,0,1,0
56963,53,63248,53,210,110,100,2,30,1,1
58535,30317,0,0,62,62,0,1,0,1,0
56377,445,0,0,66,66,0,1,0,1,0
56655,443,40290,443,8058,2038,6020,20,15,11,9
62042,445,0,0,66,66,0,1,0,1,0
11136,57587,0,0,62,62,0,1,0,1,0
58421,30188,0,0,66,66,0,1,0,1,0
64852,53,45042,53,209,110,99,2,30,1,1
56629,53,58033,53,182,93,89,2,30,1,1
58856,443,16403,443,4005,1421,2584,14,136,7,7
60044,445,0,0,70,70,0,1,0,1,0
52454,445,0,0,70,70,0,1,0,1,0
49597,53,33201,53,168,86,82,2,31,1,1
59983,443,26904,443,296863,14073,282790,351,127,130,221
55229,443,47978,443,3602,1519,2083,18,60,10,8
0,0,0,0,480,244,236,4,0,2,2
55593,80,19208,80,3276,404,2872,11,15,5,6
65529,35440,0,0,62,62,0,1,0,1,0
43872,53,52878,53,199,94,105,2,30,1,1
55311,445,0,0,70,70,0,1,0,1,0
63779,12226,36658,12226,66,66,0,2,7,2,0
51539,443,19176,443,262,70,192,5,21,2,3
55896,53,65305,53,184,94,90,2,30,1,1
27309,6881,0,0,62,62,0,1,0,1,0
13285,29892,0,0,145,145,0,1,0,1,0
63242,443,5586,443,9042,4612,4430,31,175,17,14
3875,25174,0,0,146,146,0,1,0,1,0
64956,53,40414,53,402,118,284,2,29,1,1
13281,51050,0,0,62,62,0,1,0,1,0
46327,25903,25335,25903,332,192,140,6,25,4,2
43916,21,0,0,60,60,0,1,0,1,0
55790,53,7477,53,170,87,83,2,31,1,1
23131,25174,0,0,62,62,0,1,0,1,0
65127,443,61568,443,648,648,0,7,15,7,0
62396,445,0,0,70,70,0,1,0,1,0
56835,53,48670,53,177,94,83,2,30,1,1
53146,443,41053,443,29874004,955051,28918953,31844,303,10580,21264
62727,445,0,0,70,70,0,1,0,1,0
56845,445,0,0,70,70,0,1,0,1,0
50674,445,0,0,66,66,0,1,0,1,0
57174,53,65010,53,755,94,661,2,30,1,1
49534,53,49440,53,168,86,82,2,30,1,1
57052,53,52166,53,170,87,83,2,31,1,1
16630,44847,0,0,146,146,0,1,0,1,0
23589,53,23589,53,220,90,130,2,30,1,1
51894,80,51074,80,7434,3830,3604,17,26,9,8
61942,3389,61942,3389,3347,1458,1889,15,18,8,7
64548,53,58347,53,209,110,99,2,30,1,1
42224,123,27890,123,184,94,90,2,30,1,1
58435,445,0,0,70,70,0,1,0,1,0
51558,37965,0,0,72,72,0,1,0,1,0
65480,443,49360,443,310863,9840,301023,323,16,115,208
47256,37807,0,0,62,62,0,1,0,1,0
58398,44847,0,0,62,62,0,1,0,1,0
41037,80,6510,80,613,539,74,7,15,6,1
61471,445,0,0,70,70,0,1,0,1,0
50643,443,60929,443,1512,844,668,16,64,9,7
56002,53,4276,53,771,101,670,2,31,1,1
49324,443,52610,443,6147,943,5204,17,16,9,8
57190,53,17320,53,757,102,655,2,30,1,1
56127,37965,0,0,66,66,0,1,0,1,0
51836,37753,15245,37753,70,70,0,2,7,2,0
31017,50584,0,0,62,62,0,1,0,1,0
45409,80,10508,80,1155,781,374,10,15,6,4
49862,53,59363,53,817,102,715,2,30,1,1
53447,443,53447,443,960,539,421,9,30,5,4
51486,445,0,0,70,70,0,1,0,1,0
57906,443,49224,443,9316,3279,6037,39,186,20,19
65253,53,35458,53,321,150,171,2,30,1,1
57842,445,0,0,66,66,0,1,0,1,0
64975,445,0,0,66,66,0,1,0,1,0
3478,61463,0,0,1148,1148,0,1,0,1,0
4607,6004,0,0,70,70,0,1,0,1,0
35015,17,0,0,60,60,0,1,0,1,0
37639,53,37639,53,245,106,139,2,29,1,1
59033,445,0,0,70,70,0,1,0,1,0
23824,80,23824,80,24232,4550,19682,59,17,34,25
53548,445,0,0,66,66,0,1,0,1,0
47136,53,53463,53,222,78,144,2,30,1,1
51073,80,13586,80,525373,237667,287706,1387,390,693,694
55684,80,6722,80,70,70,0,2,8,2,0
49157,53,58041,53,184,94,90,2,31,1,1
63052,445,0,0,70,70,0,1,0,1,0
57072,53,1078,53,190,97,93,2,31,1,1
49982,53,52781,53,206,105,101,2,31,1,1
50286,443,30253,443,10203,2365,7838,40,86,22,18
65187,53,58684,53,199,102,97,2,31,1,1
7160,34317,0,0,146,146,0,1,0,1,0
59043,35440,0,0,62,62,0,1,0,1,0
55635,445,0,0,70,70,0,1,0,1,0
51558,37965,0,0,72,72,0,1,0,1,0
51300,445,0,0,70,70,0,1,0,1,0
64013,57470,0,0,74,74,0,1,0,1,0
49563,443,54610,443,6462,2102,4360,18,180,8,10
55293,445,0,0,70,70,0,1,0,1,0
60184,443,60184,443,4574,1667,2907,19,26,11,8
60875,50584,0,0,62,62,0,1,0,1,0
49609,53,22044,53,170,87,83,2,30,1,1
56554,445,0,0,70,70,0,1,0,1,0
49997,53,52835,53,418,75,343,2,31,1,1
40086,22114,0,0,146,146,0,1,0,1,0
56067,53,5556,53,195,102,93,2,30,1,1
24378,5169,24378,5169,507,507,0,1,0,1,0
64049,1029,38472,1029,66,66,0,2,7,2,0
53543,44847,0,0,62,62,0,1,0,1,0
55762,53,8136,53,196,86,110,2,29,1,1
50458,443,25872,443,523577,34256,489321,1025,208,473,552
23131,25174,0,0,146,146,0,1,0,1,0
33688,80,62587,80,1638,1324,314,10,16,5,5
50077,443,40548,443,7976,3333,4643,23,25,12,11
57289,445,0,0,70,70,0,1,0,1,0
61736,50584,0,0,66,66,0,1,0,1,0
50820,57470,0,0,66,66,0,1,0,1,0
21173,37965,0,0,62,62,0,1,0,1,0
60262,443,35496,443,6627,1780,4847,23,149,13,10
55033,53,44325,53,182,94,88,2,30,1,1
64567,53,8117,53,193,102,91,2,29,1,1
51594,53,51594,53,219,92,127,2,30,1,1
37174,443,43183,443,752907,69016,683891,1372,231,537,835
65194,53,62268,53,298,102,196,2,29,1,1
53845,443,42345,443,499,425,74,4,0,3,1
63087,443,39607,443,448,166,282,2,31,1,1
55158,443,7666,443,7963,2657,5306,29,333,13,16
27005,27017,35539,27017,873,126,747,2,31,1,1
64897,53,12641,53,266,110,156,2,30,1,1
56814,53,30689,53,816,102,714,2,30,1,1
62483,445,0,0,70,70,0,1,0,1,0
45837,25174,0,0,62,62,0,1,0,1,0
64715,53,13561,53,770,102,668,2,30,1,1
39920,22114,0,0,146,146,0,1,0,1,0
26900,27017,56455,27017,926,410,516,12,31,6,6
56643,443,30724,443,8167,1980,6187,22,80,12,10
12348,50265,0,0,62,62,0,1,0,1,0
60163,26467,0,0,66,66,0,1,0,1,0
64071,53,55557,53,194,102,92,2,31,1,1
26821,57866,0,0,62,62,0,1,0,1,0
3478,61463,0,0,1292,1292,0,1,0,1,0
49743,80,24003,80,2981,473,2508,9,16,5,4
61033,39004,0,0,66,66,0,1,0,1,0
40544,53,0,0,82,82,0,1,30,1,0
6333,53,6333,53,216,90,126,2,30,1,1
63400,57470,0,0,66,66,0,1,0,1,0
21133,33447,47731,33447,481,150,331,2,1199,1,1
57121,445,0,0,70,70,0,1,0,1,0
55258,53,48782,53,177,94,83,2,30,1,1
59395,445,0,0,70,70,0,1,0,1,0
64982,53,55675,53,215,102,113,2,30,1,1
64671,53,7191,53,294,102,192,2,30,1,1
27005,32066,15067,32066,881,126,755,2,31,1,1
60579,25174,0,0,62,62,0,1,0,1,0
51087,445,0,0,70,70,0,1,0,1,0
50315,445,0,0,66,66,0,1,0,1,0
42298,58000,33594,58000,596,256,340,10,30,5,5
58413,443,5177,443,9371,1936,7435,26,29,14,12
60337,30188,0,0,66,66,0,1,0,1,0
50181,443,22681,443,6350,1071,5279,18,42,10,8
65285,50584,0,0,66,66,0,1,0,1,0
61068,445,0,0,70,70,0,1,0,1,0
61099,443,1871,443,82,82,0,1,5,1,0
54796,22114,0,0,62,62,0,1,0,1,0
64647,53,15086,53,718,94,624,2,30,1,1
41774,53,0,0,82,82,0,1,30,1,0
51832,445,0,0,66,66,0,1,0,1,0
56948,53,35699,53,93,93,0,1,30,1,0
45416,80,25189,80,2713,753,1960,12,15,7,5
38700,443,49227,443,130,70,60,2,14,1,1
63019,53,40745,53,512,166,346,2,29,1,1
55180,53,64280,53,780,93,687,2,31,1,1
59959,80,18461,80,1052,612,440,10,16,5,5
51919,443,36228,443,17595,8241,9354,80,106,43,37
30129,37965,0,0,72,72,0,1,0,1,0
63392,445,0,0,70,70,0,1,0,1,0
19944,22114,0,0,66,66,0,1,0,1,0
34331,53,34331,53,404,259,145,3,32,2,1
60271,445,0,0,70,70,0,1,0,1,0
49443,443,17566,443,70988,47020,23968,152,652,79,73
59784,443,16677,443,6698,1606,5092,23,19,13,10
60306,443,16522,443,2866,623,2243,13,136,6,7
65098,53,21613,53,740,93,647,2,31,1,1
60474,8999,37889,8999,70,70,0,2,8,2,0
60015,443,28429,443,6340,3788,2552,21,143,10,11
56837,53,12687,53,180,94,86,2,30,1,1
58638,5900,0,0,62,62,0,1,0,1,0
11136,19910,0,0,62,62,0,1,0,1,0
48420,31755,0,0,146,146,0,1,0,1,0
64611,53,9832,53,181,94,87,2,29,1,1
42973,57470,0,0,62,62,0,1,0,1,0
58719,443,6983,443,18880,7831,11049,37,18,19,18
32879,443,46058,443,8137,2110,6027,29,394,10,19
57547,445,0,0,66,66,0,1,0,1,0
46617,53,46617,53,213,87,126,2,30,1,1
36369,443,28864,443,4039,2616,1423,24,45,14,10
60139,53,31222,53,218,78,140,2,30,1,1
49236,445,0,0,70,70,0,1,0,1,0
2815,62413,0,0,66,66,0,1,0,1,0
61242,35253,0,0,66,66,0,1,0,1,0
56984,445,0,0,70,70,0,1,0,1,0
58263,5223,22492,5223,3721,1173,2548,18,20,11,7
45941,23386,0,0,60,60,0,1,0,1,0
63984,25174,0,0,62,62,0,1,0,1,0
49815,53,3379,53,789,110,679,2,31,1,1
59587,25174,0,0,62,62,0,1,0,1,0
43680,53,64871,53,271,102,169,2,30,1,1
42792,443,30288,443,7102,1857,5245,28,95,15,13
15111,53,15111,53,210,98,112,2,29,1,1
56678,53,61385,53,760,97,663,2,30,1,1
57208,53,46583,53,183,94,89,2,31,1,1
50297,80,4817,80,145266,14613,130653,165,161,63,102
63537,445,0,0,70,70,0,1,0,1,0
55826,42771,0,0,66,66,0,1,0,1,0
55661,49671,27582,49671,70,70,0,1,5,1,0
55271,53,23423,53,168,86,82,2,30,1,1
55525,53,23543,53,212,108,104,2,31,1,1
61277,445,0,0,70,70,0,1,0,1,0
60464,11385,6156,11385,1090,712,378,16,26,10,6
65460,80,65460,80,48356,4069,44287,55,48,19,36
63943,53,16297,53,258,90,168,4,56,2,2
53807,443,54173,443,499,425,74,4,0,3,1
32007,26543,0,0,145,145,0,1,0,1,0
59413,51505,0,0,66,66,0,1,0,1,0
61887,443,28383,443,81136,7785,73351,109,131,40,69
63595,51050,0,0,62,62,0,1,0,1,0
27005,27015,58465,27015,881,126,755,2,30,1,1
64194,53,10058,53,262,126,136,2,30,1,1
57585,51221,0,0,62,62,0,1,0,1,0
57799,10387,0,0,145,145,0,1,0,1,0
51179,443,22561,443,13708,1734,11974,25,31,12,13
63084,443,51859,443,571,166,405,2,30,1,1
42999,3389,42999,3389,3910,1805,2105,20,19,12,8
50796,445,0,0,66,66,0,1,0,1,0
65224,53,18679,53,197,102,95,2,30,1,1
63213,57866,0,0,66,66,0,1,0,1,0
56392,445,0,0,66,66,0,1,0,1,0
64707,53,28396,53,757,98,659,2,31,1,1
24145,35440,0,0,62,62,0,1,0,1,0
53109,41661,38343,41661,320,140,180,6,8,3,3
64648,53,9787,53,215,94,121,2,30,1,1
16994,57866,0,0,146,146,0,1,0,1,0
50345,80,27840,80,736,670,66,6,15,5,1
18085,26467,0,0,66,66,0,1,0,1,0
24021,6881,0,0,146,146,0,1,0,1,0
8915,443,26790,443,7182,1016,6166,28,412,11,17
64622,36829,0,0,62,62,0,1,0,1,0
50690,80,44292,80,56951,28706,28245,236,174,116,120
38655,443,22510,443,498,210,288,8,26,4,4
56692,443,45896,443,7914,1925,5989,20,15,11,9
59893,80,45322,80,130,70,60,2,15,1,1
51641,445,0,0,66,66,0,1,0,1,0
51304,443,20155,443,7134,3081,4053,24,121,11,13
56246,445,0,0,70,70,0,1,0,1,0
51789,80,62386,80,28433,1668,26765,39,20,18,21
57384,445,0,0,70,70,0,1,0,1,0
47910,7454,0,0,60,60,0,1,0,1,0
53418,445,0,0,70,70,0,1,0,1,0
59593,445,0,0,66,66,0,1,0,1,0
53016,80,9240,80,4419,271,4148,13,28,3,10
50308,80,8289,80,1083,653,430,8,16,5,3
64338,53,55215,53,292,102,190,2,29,1,1
42298,40022,41026,40022,717,551,166,4,31,2,2
60045,443,3000,443,1573,769,804,16,47,9,7
1377,44847,0,0,62,62,0,1,0,1,0
64116,53,5820,53,184,94,90,2,31,1,1
53901,445,0,0,70,70,0,1,0,1,0
52981,445,0,0,66,66,0,1,0,1,0
64768,53,30874,53,78,78,0,1,30,1,0
50901,26467,0,0,66,66,0,1,0,1,0
49512,80,18348,80,2225,1649,576,10,38,6,4
55344,53,18078,53,208,106,102,2,31,1,1
51189,53,6847,53,312,78,234,2,30,1,1
49713,53,3397,53,198,102,96,2,30,1,1
49886,443,58788,443,77867,2411,75456,82,87,27,55
50550,445,0,0,70,70,0,1,0,1,0
18085,26467,0,0,62,62,0,1,0,1,0
45964,55559,0,0,60,60,0,1,0,1,0
57251,37965,0,0,62,62,0,1,0,1,0
49369,443,29095,443,7165,1099,6066,16,15,9,7
59969,445,0,0,66,66,0,1,0,1,0
56775,445,0,0,70,70,0,1,0,1,0
51794,445,0,0,70,70,0,1,0,1,0
56427,53,42294,53,166,86,80,2,30,1,1
56621,53,63745,53,177,94,83,2,29,1,1
54779,50584,0,0,62,62,0,1,0,1,0
49290,445,0,0,70,70,0,1,0,1,0
64486,445,0,0,66,66,0,1,0,1,0
49529,21247,0,0,62,62,0,1,0,1,0
12951,50584,0,0,66,66,0,1,0,1,0
47037,80,10159,80,613,539,74,7,15,6,1
38562,443,22999,443,1310,649,661,13,185,7,6
37597,443,2780,443,10497,3476,7021,34,17,18,16
56773,445,0,0,70,70,0,1,0,1,0
29623,37807,0,0,62,62,0,1,0,1,0
64683,53,44457,53,370,126,244,2,30,1,1
56313,53,23049,53,198,102,96,2,30,1,1
64937,53,22410,53,182,93,89,2,31,1,1
58230,64147,0,0,66,66,0,1,0,1,0
26835,47993,0,0,62,62,0,1,0,1,0
43096,443,6267,443,7098,2628,4470,20,16,12,8
57007,80,33678,80,214,140,74,4,31,3,1
49418,27015,42779,27015,227,71,156,2,30,1,1
61860,10443,7961,10443,10811,2571,8240,27,48,15,12
50198,445,0,0,70,70,0,1,0,1,0
39426,443,8694,443,903603,21528,882075,858,57,234,624
46278,443,29099,443,6685,4843,1842,29,17,18,11
61864,80,52616,80,9747,537,9210,14,16,6,8
63995,443,63995,443,4673,1766,2907,19,29,11,8
58638,5900,0,0,62,62,0,1,0,1,0
58020,80,7358,80,2482,516,1966,11,75,6,5
57731,445,0,0,70,70,0,1,0,1,0
46190,80,10092,80,5443,2529,2914,14,515,8,6
58638,5900,58638,5900,66,66,0,1,4,1,0
49342,53,61829,53,402,118,284,2,30,1,1
61083,445,0,0,66,66,0,1,0,1,0
51819,80,5456,80,5368,946,4422,16,77,9,7
53781,36366,2063,36366,70,70,0,1,5,1,0
55795,53,50908,53,177,94,83,2,30,1,1
54548,7000,54548,7000,4487,2090,2397,15,15,8,7
60223,445,0,0,70,70,0,1,0,1,0
49562,53,45656,53,380,90,290,4,48,2,2
65514,53,17473,53,177,94,83,2,29,1,1
58638,5900,0,0,62,62,0,1,0,1,0
65495,445,0,0,70,70,0,1,0,1,0
51648,80,61615,80,3227,2425,802,9,31,5,4
61652,445,0,0,70,70,0,1,0,1,0
58006,80,48045,80,318,192,126,6,21,4,2
47238,443,16760,443,16131,4542,11589,45,139,21,24
57470,54154,42196,54154,480,149,331,2,1200,1,1
23021,25174,0,0,66,66,0,1,0,1,0
60180,31573,0,0,146,146,0,1,0,1,0
62489,445,0,0,66,66,0,1,0,1,0
56396,53,44233,53,182,93,89,2,31,1,1
54444,443,57397,443,9802,2594,7208,25,360,10,15
60864,443,60864,443,8578,2549,6029,22,16,13,9
10000,10214,0,0,62,62,0,1,0,1,0
35195,443,32117,443,3672,1259,2413,16,120,8,8
56461,53,50926,53,760,96,664,2,31,1,1
58755,53,43262,53,277,102,175,2,30,1,1
63059,445,0,0,70,70,0,1,0,1,0
59645,53,23128,53,263,94,169,2,30,1,1
49805,64147,0,0,66,66,0,1,0,1,0
26365,22,0,0,60,60,0,1,0,1,0
49363,53,56997,53,309,94,215,2,29,1,1
30188,39920,5702,39920,501,150,351,2,1200,1,1
50470,61463,0,0,86,86,0,1,0,1,0
51143,443,51143,443,33565,5938,27627,60,128,24,36
39127,6555,15189,6555,922,428,494,10,15,5,5
64112,445,0,0,70,70,0,1,0,1,0
52407,445,0,0,66,66,0,1,0,1,0
65066,445,0,0,66,66,0,1,0,1,0
38288,443,40759,443,8627,2906,5721,10,121,4,6
60773,20010,34411,20010,70,70,0,2,8,2,0
55872,445,0,0,66,66,0,1,0,1,0
49410,53,35309,53,167,86,81,2,31,1,1
27078,25174,0,0,146,146,0,1,0,1,0
993,18732,0,0,129,129,0,1,0,1,0
58638,5900,0,0,62,62,0,1,0,1,0
49573,443,25314,443,1820,1101,719,18,16,10,8
59777,443,29457,443,966,480,486,17,29,9,8
52473,443,5513,443,1625,1038,587,14,28,8,6
55859,53,29640,53,210,110,100,2,30,1,1
55009,445,0,0,70,70,0,1,0,1,0
33070,80,34842,80,3483,1578,1905,17,186,10,7
56533,53,7408,53,199,102,97,2,29,1,1
53355,23117,0,0,66,66,0,1,0,1,0
50653,80,52730,80,1658,1247,411,8,15,5,3
62470,445,0,0,66,66,0,1,0,1,0
55642,26872,53975,26872,70,70,0,2,8,2,0
11786,53,11786,53,194,87,107,2,30,1,1
56178,445,0,0,66,66,0,1,0,1,0
55489,53,32876,53,193,102,91,2,29,1,1
58638,5900,0,0,62,62,0,1,0,1,0
49326,53,62713,53,193,102,91,2,30,1,1
51221,1950,25491,1950,870,330,540,12,1316,6,6
64364,53,21283,53,193,94,99,2,31,1,1
443,35385,0,0,97,97,0,1,0,1,0
62212,445,0,0,70,70,0,1,0,1,0
55105,53,24892,53,194,94,100,2,30,1,1
53831,54676,36346,54676,492,306,186,8,16,5,3
55372,53,7749,53,271,93,178,4,43,2,2
40408,1488,40408,1488,156,156,0,3,8,3,0
51244,443,19950,443,8024,2572,5452,39,15,23,16
45624,443,55280,443,6697,1606,5091,23,17,13,10
64860,445,0,0,70,70,0,1,0,1,0
48557,37965,0,0,62,62,0,1,0,1,0
5060,37965,0,0,66,66,0,1,0,1,0
50438,53,42985,53,199,102,97,2,29,1,1
64592,53,37714,53,202,103,99,2,31,1,1
56381,53,14303,53,196,102,94,2,31,1,1
49379,53,28766,53,199,102,97,2,30,1,1
33166,53,0,0,82,82,0,2,40,2,0
60354,445,0,0,70,70,0,1,0,1,0
56762,443,61918,443,8005,1985,6020,20,15,11,9
44577,53,21603,53,199,94,105,2,30,1,1
55396,26467,0,0,62,62,0,1,0,1,0
60889,443,46801,443,9959,2430,7529,27,46,16,11
56945,53,27105,53,176,90,86,2,31,1,1
10669,49756,0,0,60,60,0,1,0,1,0
6355,25174,0,0,62,62,0,1,0,1,0
48817,50321,48817,50321,334,158,176,2,1203,1,1
52030,43068,39879,43068,70,70,0,2,8,2,0
55807,80,52839,80,73021,1232,71789,66,80,14,52
64912,53,22829,53,258,102,156,2,30,1,1
47993,443,45711,443,5272,1535,3737,17,35,12,5
35722,443,40129,443,13035,2590,10445,27,125,14,13
64763,53,29524,53,728,96,632,2,30,1,1
51816,27721,33144,27721,70,70,0,2,8,2,0
59657,445,0,0,70,70,0,1,0,1,0
9474,53,9474,53,237,91,146,2,33,1,1
56906,53,34993,53,167,86,81,2,31,1,1
48826,25174,0,0,66,66,0,1,0,1,0
58736,53,58736,53,235,90,145,2,32,1,1
55604,44235,60786,44235,504,318,186,8,15,5,3
64493,53,24989,53,280,97,183,4,59,2,2
42298,40005,17939,40005,263,182,81,2,30,1,1
55752,53,44697,53,200,102,98,2,30,1,1
49657,443,35292,443,2800,1557,1243,33,53,19,14
55718,16805,50581,16805,70,70,0,1,5,1,0
63955,53,0,0,219,81,138,2,30,1,1
58638,5900,0,0,62,62,0,1,0,1,0
50667,80,4915,80,3778,2082,1696,12,21,7,5
59942,80,31955,80,2241,1549,692,9,15,5,4
56673,443,15225,443,7941,1952,5989,20,15,11,9
16979,56205,0,0,62,62,0,1,0,1,0
46093,32661,0,0,74,74,0,1,0,1,0
36503,443,18047,443,3549,899,2650,13,120,6,7
39771,443,64614,443,6903,1273,5630,25,255,13,12
59786,443,7763,443,170002,17069,152933,229,48,118,111
65409,53,26325,53,753,93,660,2,31,1,1
57833,443,7309,443,215996,13055,202941,265,127,96,169
65426,53,23528,53,706,195,511,6,52,3,3
49674,53,9150,53,211,102,109,2,29,1,1
65360,445,0,0,66,66,0,1,0,1,0
63662,445,0,0,70,70,0,1,0,1,0
26900,27017,60170,27017,422,164,258,6,30,3,3
63952,53,35871,53,289,102,187,2,30,1,1
56785,53,32079,53,193,102,91,2,30,1,1
54060,445,0,0,70,70,0,1,0,1,0
50552,80,50552,80,2887,1776,1111,14,22,8,6
42615,25174,0,0,146,146,0,1,0,1,0
57344,53,21861,53,177,94,83,2,30,1,1
20270,3478,6426,3478,443,294,149,2,300,1,1
64803,53,24000,53,303,303,0,4,47,4,0
51887,16514,22575,16514,70,70,0,2,8,2,0
50518,80,23907,80,2864,1338,1526,17,21,9,8
49188,8108,9022,8108,1788,1016,772,15,15,8,7
56170,53,63567,53,198,102,96,2,30,1,1
37616,443,4256,443,18611,3046,15565,41,362,20,21
40379,53,38675,53,168,78,90,2,30,1,1
38131,443,7949,443,85590,4656,80934,111,37,47,64
63214,53,63214,53,261,103,158,2,30,1,1
443,60496,0,0,320,320,0,1,0,1,0
49713,445,0,0,66,66,0,1,0,1,0
49646,53,5301,53,199,102,97,2,30,1,1
56709,445,0,0,66,66,0,1,0,1,0
11907,57470,0,0,66,66,0,1,0,1,0
35271,443,35271,443,134405,6968,127437,187,97,85,102
51418,53,32808,53,168,78,90,2,30,1,1
55784,53,2771,53,184,94,90,2,30,1,1
56964,53,17076,53,267,87,180,4,53,2,2
6712,123,0,0,90,90,0,1,0,1,0
52866,445,0,0,70,70,0,1,0,1,0
48020,7484,0,0,60,60,0,1,0,1,0
46860,15000,54542,15000,130,70,60,2,6,1,1
57177,443,54507,443,1610,771,839,22,120,11,11
58153,445,0,0,70,70,0,1,0,1,0
50418,445,0,0,66,66,0,1,0,1,0
50097,53,57646,53,199,94,105,2,30,1,1
39995,443,64142,443,6812,2910,3902,31,282,8,23
60899,7275,19563,7275,2875,449,2426,12,16,7,5
38049,80,38049,80,2180,1555,625,9,86,6,3
64421,53,53236,53,398,88,310,4,54,2,2
51300,64147,0,0,66,66,0,1,0,1,0
51350,445,0,0,70,70,0,1,0,1,0
51933,80,40922,80,3676,2136,1540,15,40,10,5
9150,443,24673,443,16023,3677,12346,42,37,21,21
56667,53,35767,53,168,86,82,2,29,1,1
16630,44847,0,0,62,62,0,1,0,1,0
61716,443,60379,443,3168,1038,2130,16,136,8,8
52973,57470,0,0,74,74,0,1,0,1,0
55030,445,0,0,70,70,0,1,0,1,0
44121,23,0,0,60,60,0,1,0,1,0
2849,30188,0,0,66,66,0,1,0,1,0
49976,22114,0,0,66,66,0,1,0,1,0
5060,37965,0,0,66,66,0,1,0,1,0
5223,44091,0,0,220,220,0,1,0,1,0
55106,53,41822,53,177,94,83,2,30,1,1
59677,445,0,0,70,70,0,1,0,1,0
6881,6889,18694,6889,221,111,110,2,1200,1,1
58582,50584,0,0,66,66,0,1,0,1,0
50791,53,50791,53,231,90,141,2,30,1,1
55714,53,64632,53,173,94,79,2,30,1,1
60187,443,37474,443,5656,1936,3720,23,57,11,12
15241,53,62094,53,215,86,129,2,30,1,1
51888,42529,42090,42529,316,136,180,6,6,3,3
31214,53,31214,53,216,90,126,2,30,1,1
63919,80,26463,80,314,192,122,6,15,4,2
5223,1210,0,0,103,103,0,1,0,1,0
53750,25174,0,0,62,62,0,1,0,1,0
65099,53,38778,53,199,102,97,2,29,1,1
50292,22114,0,0,66,66,0,1,0,1,0
64750,53,43856,53,193,102,91,2,30,1,1
56711,25174,0,0,146,146,0,1,0,1,0
38976,46824,0,0,62,62,0,1,0,1,0
59055,11392,0,0,62,62,0,1,0,1,0
51232,23,0,0,60,60,0,1,0,1,0
56113,443,21683,443,103486,7416,96070,161,42,82,79
54669,80,16041,80,1148,599,549,14,318,7,7
33642,443,1036,443,8533,4446,4087,65,160,32,33
59779,443,64471,443,70,70,0,1,5,1,0
49177,443,40595,443,840,700,140,13,59,11,2
62726,445,0,0,66,66,0,1,0,1,0
64091,443,50015,443,3258,1197,2061,14,136,7,7
51847,32112,38487,32112,70,70,0,2,9,2,0
58862,445,0,0,70,70,0,1,0,1,0
37110,53,37110,53,247,98,149,2,33,1,1
55387,53,41194,53,164,86,78,2,30,1,1
37580,443,41939,443,24810,10597,14213,51,123,22,29
54996,53,14810,53,168,86,82,2,31,1,1
6881,6881,0,0,62,62,0,1,0,1,0
35568,443,33534,443,5383,3710,1673,27,309,14,13
64723,53,45766,53,329,118,211,2,30,1,1
50878,53733,0,0,66,66,0,1,0,1,0
45225,443,59513,443,11233,3101,8132,37,150,18,19
55857,53,27164,53,192,98,94,2,30,1,1
52163,14181,27565,14181,70,70,0,1,5,1,0
49210,33757,53103,33757,70,70,0,2,8,2,0
56844,443,48471,443,10878,4815,6063,60,196,31,29
10701,11392,0,0,62,62,0,1,0,1,0
57163,53,34170,53,209,110,99,2,30,1,1
50468,80,50468,80,90393,7684,82709,132,22,69,63
65224,445,0,0,66,66,0,1,0,1,0
58382,445,0,0,70,70,0,1,0,1,0
65023,53,34897,53,587,104,483,4,40,2,2
64076,53,25451,53,255,102,153,2,30,1,1
60307,443,42783,443,5574,1200,4374,26,80,13,13
22574,44847,0,0,62,62,0,1,0,1,0
63136,25174,0,0,62,62,0,1,0,1,0
55164,445,0,0,66,66,0,1,0,1,0
57340,53,7589,53,216,110,106,2,30,1,1
49520,53,8068,53,209,110,99,2,29,1,1
43063,57470,0,0,62,62,0,1,0,1,0
55160,445,0,0,70,70,0,1,0,1,0
6881,48947,47849,48947,228,118,110,2,1199,1,1
57122,53,4958,53,199,102,97,2,29,1,1
63741,50584,0,0,62,62,0,1,0,1,0
55617,445,0,0,66,66,0,1,0,1,0
51355,445,0,0,70,70,0,1,0,1,0
45628,80,45628,80,1243,530,713,10,20,5,5
54252,443,11078,443,499,425,74,4,0,3,1
56361,443,32525,443,3775,1791,1984,24,203,12,12
55088,53,51001,53,177,94,83,2,29,1,1
58631,445,0,0,70,70,0,1,0,1,0
58638,5900,0,0,62,62,0,1,0,1,0
64213,53,34758,53,342,105,237,4,53,2,2
45994,443,45994,443,1494,898,596,12,142,6,6
9155,443,45491,443,5734,498,5236,14,15,7,7
52559,443,18708,443,4479,2526,1953,10,120,6,4
63404,445,0,0,70,70,0,1,0,1,0
55154,53,39546,53,184,94,90,2,30,1,1
27005,27017,41161,27017,883,126,757,2,30,1,1
40204,40001,61401,40001,244,181,63,2,31,1,1
52044,445,0,0,70,70,0,1,0,1,0
51525,35440,0,0,66,66,0,1,0,1,0
57135,53,40947,53,443,182,261,6,30,3,3
63520,445,0,0,66,66,0,1,0,1,0
61594,445,0,0,66,66,0,1,0,1,0
65112,53,26607,53,209,110,99,2,30,1,1
62945,445,0,0,70,70,0,1,0,1,0
56613,443,29986,443,7981,1961,6020,20,16,11,9
60501,40829,11084,40829,70,70,0,2,8,2,0
29988,44847,0,0,66,66,0,1,0,1,0
56938,80,50995,80,1403,841,562,10,75,6,4
64957,445,0,0,70,70,0,1,0,1,0
65146,53,65321,53,335,102,233,2,30,1,1
49983,53,2734,53,211,110,101,2,30,1,1
52182,60769,63523,60769,70,70,0,2,8,2,0
60948,53,22265,53,168,78,90,2,30,1,1
25533,22114,0,0,62,62,0,1,0,1,0
53028,80,62533,80,70,70,0,1,5,1,0
52882,445,0,0,70,70,0,1,0,1,0
5938,39160,0,0,60,60,0,1,91,1,0
50090,445,0,0,70,70,0,1,0,1,0
64824,37965,0,0,62,62,0,1,0,1,0
16092,50265,0,0,62,62,0,1,0,1,0
50052,65008,0,0,60,60,0,1,0,1,0
49175,2710,30746,2710,70,70,0,2,8,2,0
52438,445,0,0,70,70,0,1,0,1,0
54025,53,41690,53,578,286,292,9,0,5,4
61408,443,17703,443,9492,3543,5949,49,117,25,24
45019,443,10530,443,33865,6559,27306,67,67,34,33
57010,53,46777,53,199,102,97,2,30,1,1
35156,8635,35156,8635,138,78,60,2,5,1,1
32299,40015,23096,40015,188,70,118,2,31,1,1
50124,443,33361,443,24329,7675,16654,47,16,25,22
56324,445,0,0,66,66,0,1,0,1,0
35191,53,35191,53,825,99,726,2,31,1,1
55222,53,4063,53,181,94,87,2,30,1,1
43791,443,3031,443,6933,1677,5256,22,305,12,10
56199,53,59192,53,227,110,117,2,30,1,1
63791,48817,0,0,145,145,0,1,0,1,0
58509,443,26840,443,13973721,436876,13536845,14039,1629,4929,9110
53162,445,0,0,70,70,0,1,0,1,0
64886,53,49173,53,199,102,97,2,29,1,1
58638,5900,0,0,62,62,0,1,0,1,0
65349,53,30593,53,772,103,669,2,31,1,1
51996,80,49659,80,6518746,206365,6312381,6886,22,2687,4199
53540,34134,25153,34134,70,70,0,1,5,1,0
5831,22114,0,0,62,62,0,1,0,1,0
60746,445,0,0,66,66,0,1,0,1,0
26449,80,26449,80,642,338,304,10,33,6,4
0,0,0,0,156,156,0,2,0,2,0
62815,445,0,0,70,70,0,1,0,1,0
64756,11392,0,0,146,146,0,1,0,1,0
65379,22114,0,0,66,66,0,1,0,1,0
53804,24067,52480,24067,70,70,0,2,7,2,0
25565,55690,0,0,60,60,0,1,0,1,0
54351,23,0,0,60,60,0,1,0,1,0
49359,445,0,0,70,70,0,1,0,1,0
25009,35440,0,0,66,66,0,1,0,1,0
49537,53,41171,53,686,276,410,8,74,4,4
50886,80,22505,80,312952,13869,299083,347,141,138,209
45932,53,57917,53,199,94,105,2,30,1,1
49589,443,40471,443,327575,8400,319175,334,316,113,221
60781,443,56303,443,5964,3582,2382,17,136,8,9
57401,53,55696,53,179,94,85,2,31,1,1
52663,443,53022,443,4416,1702,2714,19,126,9,10
55296,23718,0,0,66,66,0,1,0,1,0
60550,50584,0,0,62,62,0,1,0,1,0
56385,53,22600,53,249,85,164,4,55,2,2
53928,15503,0,0,62,62,0,1,0,1,0
59015,445,0,0,70,70,0,1,0,1,0
46271,443,30209,443,70,70,0,2,4,2,0
50625,445,0,0,70,70,0,1,0,1,0
50784,50584,0,0,62,62,0,1,0,1,0
58638,5900,58638,5900,62,62,0,1,5,1,0
58558,53,58236,53,268,86,182,2,30,1,1
60575,445,0,0,66,66,0,1,0,1,0
64583,53,5543,53,426,89,337,4,58,2,2
8999,59353,0,0,146,146,0,1,0,1,0
64920,445,0,0,66,66,0,1,0,1,0
57628,445,0,0,70,70,0,1,0,1,0
57470,13613,29471,13613,1577,594,983,20,1600,10,10
59419,80,51819,80,3442,1672,1770,19,22,10,9
15605,50265,0,0,62,62,0,1,0,1,0
55183,53,52172,53,177,94,83,2,30,1,1
54350,443,6406,443,2402,1444,958,18,167,10,8
17415,25174,0,0,62,62,0,1,0,1,0
16403,16384,41860,16384,122,62,60,2,30,1,1
55830,53,20748,53,177,94,83,2,30,1,1
11066,50584,0,0,66,66,0,1,0,1,0
58715,57470,0,0,66,66,0,1,0,1,0
64035,25174,0,0,146,146,0,1,0,1,0
61318,445,0,0,70,70,0,1,0,1,0
34531,23117,0,0,62,62,0,1,0,1,0
59487,443,5005,443,8702,580,8122,17,53,5,12
61004,445,0,0,66,66,0,1,0,1,0
64024,22114,0,0,62,62,0,1,0,1,0
59007,443,65066,443,2608,1523,1085,19,15,10,9
56257,53,40578,53,177,94,83,2,31,1,1
64941,445,0,0,70,70,0,1,0,1,0
57319,53,20750,53,180,94,86,2,29,1,1
58638,5900,0,0,62,62,0,1,0,1,0
51891,23238,33315,23238,70,70,0,2,8,2,0
55058,53,31545,53,216,110,106,2,30,1,1
60390,56494,64175,56494,70,70,0,2,8,2,0
55754,53,32469,53,170,87,83,2,31,1,1
64934,53,52297,53,197,102,95,2,33,1,1
57797,445,0,0,70,70,0,1,0,1,0
53705,443,25596,443,1579,988,591,13,44,7,6
56588,443,17428,443,15450,6149,9301,106,177,47,59
51929,53371,7224,53371,70,70,0,2,8,2,0
48632,443,58774,443,12433,4515,7918,32,136,17,15
65489,445,0,0,70,70,0,1,0,1,0
50243,445,0,0,70,70,0,1,0,1,0
45676,123,45676,123,184,94,90,2,30,1,1
49946,445,0,0,70,70,0,1,0,1,0
59940,50584,0,0,66,66,0,1,0,1,0
62491,445,0,0,66,66,0,1,0,1,0
54983,80,49933,80,27816,7362,20454,69,240,41,28
51759,55308,19017,55308,70,70,0,1,5,1,0
58829,64147,0,0,66,66,0,1,0,1,0
48542,80,42394,80,811,671,140,6,32,4,2
51081,443,34616,443,8192,2781,5411,22,374,12,10
34912,443,42889,443,36366,2297,34069,51,139,21,30
54986,445,0,0,70,70,0,1,0,1,0
49228,443,49228,443,32952,11546,21406,60,71,36,24
50906,443,11737,443,124,64,60,2,15,1,1
4544,3478,63036,3478,338,110,228,2,299,1,1
51756,41471,58464,41471,70,70,0,1,5,1,0
64697,53,51206,53,199,102,97,2,30,1,1
55836,53,6468,53,177,94,83,2,30,1,1
58058,53,0,0,86,86,0,1,30,1,0
41164,443,60993,443,8949,1938,7011,21,17,12,9
50485,443,22667,443,6028,2012,4016,25,16,14,11
55710,445,0,0,70,70,0,1,0,1,0
27005,27015,15539,27015,881,126,755,2,30,1,1
42231,57470,0,0,78,78,0,1,0,1,0
1943,48817,0,0,66,66,0,1,0,1,0
27502,50584,0,0,62,62,0,1,0,1,0
55066,53,18793,53,176,90,86,2,31,1,1
59396,445,0,0,70,70,0,1,0,1,0
57170,53,13134,53,298,102,196,4,36,2,2
61699,445,0,0,70,70,0,1,0,1,0
34358,80,63755,80,350,210,140,6,16,4,2
63560,53,63560,53,209,79,130,2,30,1,1
55106,53,55106,53,200,90,110,2,30,1,1
49937,80,61073,80,1130,613,517,11,15,6,5
63621,30188,0,0,62,62,0,1,0,1,0
54709,445,0,0,66,66,0,1,0,1,0
43513,443,9885,443,224,164,60,3,5,2,1
54962,53,15807,53,194,102,92,2,30,1,1
9231,3389,0,0,66,66,0,1,0,1,0
50679,80,31176,80,2139,1167,972,10,20,6,4
53504,445,0,0,70,70,0,1,0,1,0
49636,443,48846,443,6158,1149,5009,17,52,9,8
64422,53,39408,53,180,94,86,2,31,1,1
3478,61463,0,0,164,164,0,1,0,1,0
60482,445,0,0,70,70,0,1,0,1,0
52134,445,0,0,70,70,0,1,0,1,0
56986,53,20950,53,259,87,172,4,37,2,2
49433,445,0,0,70,70,0,1,0,1,0
52401,443,47720,443,12402,3972,8430,46,138,26,20
62029,36237,0,0,62,62,0,1,0,1,0
64671,445,0,0,70,70,0,1,0,1,0
57470,26944,61791,26944,480,149,331,2,1200,1,1
60735,28080,14759,28080,70,70,0,1,5,1,0
54989,50265,0,0,66,66,0,1,0,1,0
50356,53,30610,53,180,94,86,2,30,1,1
49429,53,36318,53,210,110,100,2,30,1,1
34469,53,59263,53,226,78,148,2,30,1,1
50346,80,22819,80,502,250,252,9,41,5,4
49160,46824,0,0,146,146,0,1,0,1,0
49961,445,0,0,70,70,0,1,0,1,0
58638,5900,0,0,62,62,0,1,0,1,0
56015,53,32700,53,190,97,93,2,31,1,1
56925,445,0,0,66,66,0,1,0,1,0
51401,6881,0,0,66,66,0,1,0,1,0
39175,80,7841,80,1712,1324,388,11,16,5,6
60869,48817,0,0,62,62,0,1,0,1,0
37851,443,26132,443,14283,12630,1653,29,126,17,12
35628,443,42437,443,7840,1829,6011,24,85,14,10
50005,53,1672,53,199,102,97,2,30,1,1
49487,60043,0,0,62,62,0,1,0,1,0
17573,44847,0,0,146,146,0,1,0,1,0
57063,445,0,0,70,70,0,1,0,1,0
23150,53,23150,53,365,233,132,3,32,2,1
56081,53,46764,53,186,102,84,2,29,1,1
53844,16925,27697,16925,940,502,438,14,18,7,7
49001,48817,0,0,160,160,0,1,0,1,0
57862,443,61289,443,448344,11729,436615,474,157,128,346
39474,443,60202,443,9766,2050,7716,23,15,12,11
19875,30170,0,0,145,145,0,1,0,1,0
52252,46314,0,0,62,62,0,1,0,1,0
50945,445,0,0,66,66,0,1,0,1,0
56813,37092,33767,37092,70,70,0,1,5,1,0
53332,80,59740,80,9094,5469,3625,22,166,12,10
53318,80,64678,80,1536,982,554,10,76,6,4
55422,445,0,0,66,66,0,1,0,1,0
60411,58131,27448,58131,70,70,0,1,5,1,0
37673,443,65454,443,3226,2225,1001,18,47,11,7
49302,445,0,0,70,70,0,1,0,1,0
65127,443,37615,443,146,64,82,3,9,2,1
50073,443,27421,443,22729,6539,16190,54,93,27,27
50493,80,1565,80,318,192,126,6,25,4,2
58759,445,0,0,70,70,0,1,0,1,0
49554,445,0,0,70,70,0,1,0,1,0
33908,48983,0,0,145,145,0,1,0,1,0
33861,443,34883,443,8084,2638,5446,26,20,14,12
64804,53,31085,53,182,102,80,2,30,1,1
44855,58414,0,0,146,146,0,1,0,1,0
37466,443,58228,443,13829,1724,12105,28,516,13,15
35691,123,42659,123,184,94,90,2,30,1,1
3688,80,37150,80,7072,1145,5927,20,105,12,8
3229,53,3229,53,244,98,146,2,31,1,1
1660,8696,0,0,145,145,0,1,0,1,0
51760,50584,0,0,62,62,0,1,0,1,0
26527,25174,0,0,66,66,0,1,0,1,0
50159,445,0,0,70,70,0,1,0,1,0
26424,27189,0,0,66,66,0,1,0,1,0
56127,445,0,0,66,66,0,1,0,1,0
50168,445,0,0,66,66,0,1,0,1,0
65003,57470,0,0,78,78,0,1,0,1,0
53413,35440,0,0,146,146,0,1,0,1,0
123,123,14772,123,184,94,90,2,29,1,1
57164,443,51715,443,522,78,444,8,22,2,6
52253,443,52253,443,429263,14390,414873,449,24,159,290
56083,445,0,0,70,70,0,1,0,1,0
49776,53,43757,53,182,94,88,2,29,1,1
27507,25174,0,0,146,146,0,1,0,1,0
55193,53,45543,53,200,102,98,2,30,1,1
36838,443,43654,443,9381,1457,7924,21,31,11,10
61360,445,0,0,70,70,0,1,0,1,0
44136,53,62801,53,220,78,142,2,30,1,1
60897,445,0,0,66,66,0,1,0,1,0
56583,53,33992,53,177,94,83,2,29,1,1
49674,443,62205,443,8656,2060,6596,20,57,10,10
22357,6004,0,0,62,62,0,1,0,1,0
59417,443,49153,443,2898,1700,1198,16,15,8,8
57180,53,28550,53,305,86,219,2,31,1,1
42798,26467,0,0,62,62,0,1,0,1,0
55535,53,57254,53,199,102,97,2,30,1,1
53048,445,0,0,70,70,0,1,0,1,0
65365,53,21509,53,178,94,84,2,29,1,1
51525,445,0,0,70,70,0,1,0,1,0
22240,22114,0,0,62,62,0,1,0,1,0
1183,53,1183,53,213,79,134,2,33,1,1
63241,445,0,0,66,66,0,1,0,1,0
45727,443,38522,443,1625,1038,587,14,29,8,6
53431,80,15544,80,1638,1324,314,10,15,5,5
55608,445,0,0,66,66,0,1,0,1,0
61504,443,15507,443,16708,2331,14377,31,21,14,17
64659,53,14647,53,464,99,365,4,39,2,2
56492,53,6474,53,184,94,90,2,30,1,1
63124,445,0,0,70,70,0,1,0,1,0
53268,445,0,0,70,70,0,1,0,1,0
59416,443,53026,443,10642,3654,6988,26,125,14,12
50520,53,8153,53,183,94,89,2,30,1,1
10639,11392,0,0,62,62,0,1,0,1,0
54104,445,0,0,70,70,0,1,0,1,0
5588,5588,0,0,3562,1936,1626,48,195,24,24
58959,53,45652,53,307,86,221,2,30,1,1
58718,443,59357,443,1129,599,530,12,25,6,6
62547,443,41349,443,54095,6413,47682,151,450,61,90
63692,42635,61565,42635,562,380,182,8,15,5,3
9202,80,37636,80,2949,546,2403,11,25,6,5
53835,62413,0,0,62,62,0,1,0,1,0
41463,20005,0,0,60,60,0,1,0,1,0
8283,45858,25688,45858,130,70,60,2,30,1,1
57344,443,60771,443,3872,1641,2231,14,125,6,8
57632,445,0,0,70,70,0,1,0,1,0
54956,53,56541,53,194,102,92,2,30,1,1
60048,443,33885,443,12254,3186,9068,27,171,13,14
64125,53,55658,53,370,94,276,2,30,1,1
56054,53,43314,53,740,93,647,2,31,1,1
64486,53,21384,53,290,102,188,2,30,1,1
50433,80,24726,80,318,192,126,6,26,4,2
65314,53,31001,53,195,102,93,2,30,1,1
43634,80,30485,80,1151,711,440,10,15,5,5
62856,445,0,0,66,66,0,1,0,1,0
42490,1433,0,0,60,60,0,1,0,1,0
61859,445,0,0,70,70,0,1,0,1,0
63583,37965,0,0,66,66,0,1,0,1,0
54138,443,3905,443,5702,1212,4490,19,139,10,9
56754,14715,43516,14715,66,66,0,1,5,1,0
58392,445,0,0,70,70,0,1,0,1,0
47102,123,23383,123,184,94,90,2,30,1,1
53106,445,0,0,70,70,0,1,0,1,0
59809,443,46540,443,35140,3700,31440,67,76,30,37
7275,9524,0,0,66,66,0,1,0,1,0
55812,53,26314,53,215,94,121,2,30,1,1
3777,64097,0,0,146,146,0,1,0,1,0
49226,53,53578,53,765,102,663,2,30,1,1
57325,60043,0,0,66,66,0,1,0,1,0
52094,443,44037,443,2983,1667,1316,25,153,12,13
47821,443,31829,443,71624,60795,10829,194,131,110,84
21133,26760,14164,26760,480,149,331,2,1200,1,1
7877,22114,0,0,66,66,0,1,0,1,0
47905,443,5382,443,172,172,0,2,5,2,0
65440,53,2075,53,189,102,87,2,30,1,1
37672,5223,8222,5223,110,110,0,1,5,1,0
64605,25174,0,0,66,66,0,1,0,1,0
55887,53,33560,53,166,86,80,2,31,1,1
49316,53,24928,53,184,94,90,2,31,1,1
50615,445,0,0,70,70,0,1,0,1,0
59688,445,0,0,66,66,0,1,0,1,0
56455,445,0,0,66,66,0,1,0,1,0
57226,53,37479,53,178,94,84,2,30,1,1
57470,43155,32052,43155,594,594,0,10,1199,10,0
54657,445,0,0,70,70,0,1,0,1,0
52549,445,0,0,66,66,0,1,0,1,0
62335,443,30924,443,73341,3336,70005,85,48,27,58
50528,445,0,0,70,70,0,1,0,1,0
46488,443,7780,443,87129,6924,80205,126,258,49,77
64321,53,31319,53,190,97,93,2,31,1,1
64805,53,57151,53,215,102,113,2,30,1,1
26792,37965,0,0,62,62,0,1,0,1,0
49972,80,64274,80,95065,52092,42973,148,259,77,71
54667,445,0,0,70,70,0,1,0,1,0
59848,53,28215,53,239,102,137,2,30,1,1
56814,53,9627,53,193,102,91,2,30,1,1
64113,445,0,0,70,70,0,1,0,1,0
49318,445,0,0,70,70,0,1,0,1,0
60723,445,0,0,70,70,0,1,0,1,0
51550,53,60452,53,168,78,90,2,30,1,1
60092,443,60092,443,4700,1793,2907,19,28,11,8
443,54507,0,0,82,82,0,1,0,1,0
56652,80,38597,80,234,234,0,4,12,4,0
56352,53,18136,53,177,94,83,2,30,1,1
55659,37787,37419,37787,70,70,0,1,5,1,0
30783,51505,0,0,62,62,0,1,0,1,0
57096,53,11827,53,198,102,96,2,30,1,1
56683,445,0,0,70,70,0,1,0,1,0
58692,53,28574,53,199,94,105,2,30,1,1
26553,57470,0,0,66,66,0,1,0,1,0
61658,445,0,0,66,66,0,1,0,1,0
49927,80,6147,80,1141,636,505,10,45,6,4
49231,445,0,0,70,70,0,1,0,1,0
27450,443,32260,443,10099,1635,8464,31,83,14,17
54085,443,49010,443,4128,1929,2199,38,48,21,17
60435,80,13780,80,5518,527,4991,13,75,6,7
55440,445,0,0,70,70,0,1,0,1,0
65470,445,0,0,70,70,0,1,0,1,0
51726,18475,34444,18475,316,136,180,6,7,3,3
51486,4545,51486,4545,156,156,0,3,8,3,0
49160,57470,0,0,146,146,0,1,0,1,0
60401,445,0,0,70,70,0,1,0,1,0
50548,443,50022,443,9277,2865,6412,31,200,18,13
53875,43611,37582,43611,70,70,0,1,5,1,0
64534,53,35373,53,214,110,104,2,30,1,1
57529,445,0,0,66,66,0,1,0,1,0
58655,445,0,0,66,66,0,1,0,1,0
65513,53,49907,53,186,102,84,2,30,1,1
56086,443,37563,443,7535,1003,6532,24,304,7,17
59019,445,0,0,66,66,0,1,0,1,0
62865,443,23097,443,21313,7245,14068,48,128,22,26
49312,443,38998,443,3171,2293,878,17,40,10,7
61798,35440,0,0,66,66,0,1,0,1,0
35628,443,46062,443,8414,4131,4283,36,64,16,20
49549,443,60727,443,5903,1270,4633,14,17,8,6
49622,53,6128,53,209,102,107,2,30,1,1
59709,445,0,0,66,66,0,1,0,1,0
54339,23117,0,0,66,66,0,1,0,1,0
46808,25174,0,0,62,62,0,1,0,1,0
26053,33720,0,0,160,160,0,1,0,1,0
50413,80,12074,80,8388,2010,6378,17,23,8,9
57003,80,40780,80,526,304,222,8,35,5,3
60126,443,24609,443,3015,2086,929,16,15,9,7
53763,443,53593,443,499,425,74,4,0,3,1
49788,53,44900,53,196,100,96,2,30,1,1
57825,13014,0,0,74,74,0,1,0,1,0
49885,443,59973,443,37539,4310,33229,63,51,27,36
58638,5900,58638,5900,66,66,0,1,4,1,0
55336,443,52055,443,209596,37190,172406,378,79,184,194
62506,445,0,0,66,66,0,1,0,1,0
56279,23,0,0,60,60,0,1,0,1,0
27888,53,27888,53,240,96,144,2,31,1,1
58162,445,0,0,70,70,0,1,0,1,0
55962,53,37019,53,193,102,91,2,30,1,1
29011,32468,0,0,66,66,0,1,0,1,0
37965,10909,61398,10909,844,152,692,4,1199,2,2
55634,53,8065,53,210,110,100,2,30,1,1
26900,27017,65080,27017,422,164,258,6,30,3,3
4419,23,0,0,60,60,0,1,0,1,0
46902,443,9815,443,1312,651,661,13,184,7,6
60857,443,19971,443,18385,7771,10614,47,48,27,20
56429,80,57755,80,17188,1559,15629,25,25,10,15
37965,56605,48626,56605,847,152,695,4,1201,2,2
49230,53,36534,53,351,94,257,2,30,1,1
24606,55783,0,0,72,72,0,1,0,1,0
64854,53,27051,53,178,94,84,2,30,1,1
56634,443,30287,443,8654,2150,6504,20,15,11,9
60276,445,0,0,66,66,0,1,0,1,0
50077,53,35101,53,787,110,677,2,30,1,1
54062,31573,0,0,66,66,0,1,0,1,0
50269,80,46714,80,1606,823,783,12,121,7,5
13408,44847,0,0,66,66,0,1,0,1,0
52210,15604,53741,15604,70,70,0,1,5,1,0
33877,53,33877,53,643,88,555,2,31,1,1
55734,53,29847,53,733,94,639,2,30,1,1
60617,445,0,0,70,70,0,1,0,1,0
63758,443,30040,443,3263,1643,1620,9,119,5,4
50577,53,42323,53,819,102,717,2,30,1,1
50543,443,11342,443,11275,4454,6821,24,36,13,11
57702,53,57702,53,398,255,143,3,32,2,1
61053,44847,0,0,66,66,0,1,0,1,0
61261,445,0,0,66,66,0,1,0,1,0
64122,53,40984,53,214,110,104,2,30,1,1
4483,53,4483,53,213,87,126,2,31,1,1
64472,53,59070,53,183,94,89,2,31,1,1
48440,443,28168,443,6945,1551,5394,25,200,12,13
51691,445,0,0,70,70,0,1,0,1,0
30181,61689,0,0,62,62,0,1,0,1,0
64340,53,64340,53,237,91,146,2,33,1,1
53116,32014,29630,32014,698,320,378,10,17,6,4
59605,443,24489,443,4507,1525,2982,24,148,13,11
51432,443,60618,443,194,70,124,3,11,1,2
17010,57470,0,0,62,62,0,1,0,1,0
50919,443,16242,443,5962,1621,4341,16,75,9,7
50066,30188,0,0,66,66,0,1,0,1,0
15296,37965,0,0,66,66,0,1,0,1,0
57369,16881,7618,16881,564,318,246,9,15,5,4
48756,443,37837,443,6353,1075,5278,18,33,10,8
64997,445,0,0,70,70,0,1,0,1,0
55072,53,57853,53,701,88,613,2,30,1,1
49418,27017,43664,27017,259,71,188,2,31,1,1
39119,44847,0,0,62,62,0,1,0,1,0
56268,44847,0,0,66,66,0,1,0,1,0
58449,445,0,0,70,70,0,1,0,1,0
60417,55100,62868,55100,164,70,94,2,5,1,1
27005,27015,18996,27015,1618,126,1492,4,30,2,2
26229,80,26229,80,7372,954,6418,17,18,9,8
31609,26296,0,0,148,148,0,1,0,1,0
4748,64147,0,0,62,62,0,1,0,1,0
32299,40019,6627,40019,261,175,86,2,31,1,1
55079,445,0,0,70,70,0,1,0,1,0
49182,445,0,0,66,66,0,1,0,1,0
58756,443,10542,443,5168,700,4468,16,15,7,9
51548,80,13460,80,1861,1219,642,10,15,5,5
38672,443,23620,443,4478,1133,3345,13,35,8,5
44448,443,36659,443,5960,1651,4309,21,85,12,9
64361,53,32766,53,228,110,118,2,30,1,1
45766,2323,0,0,60,60,0,1,0,1,0
41243,443,21826,443,3697,2379,1318,26,16,14,12
60515,445,0,0,70,70,0,1,0,1,0
34808,22114,0,0,66,66,0,1,0,1,0
55031,5222,39174,5222,6192,3767,2425,53,64,29,24
61341,445,0,0,70,70,0,1,0,1,0
50584,51413,31560,51413,800,150,650,4,1200,2,2
54865,443,54865,443,125282,21435,103847,162,20,80,82
63686,445,0,0,70,70,0,1,0,1,0
50477,80,50477,80,20873,1203,19670,30,21,13,17
63180,445,0,0,66,66,0,1,0,1,0
61637,25174,0,0,66,66,0,1,0,1,0
63954,60430,18529,60430,66,66,0,2,8,2,0
65000,53,40784,53,168,86,82,2,30,1,1
52853,445,0,0,66,66,0,1,0,1,0
65237,53,38520,53,733,86,647,2,30,1,1
52791,25174,0,0,66,66,0,1,0,1,0
65410,443,49825,443,2494,1643,851,17,25,9,8
49418,27015,2773,27015,243,78,165,2,30,1,1
47037,1,0,0,62,62,0,1,0,1,0
56937,53,62951,53,181,94,87,2,30,1,1
64633,53,20577,53,255,102,153,2,30,1,1
53624,445,0,0,66,66,0,1,0,1,0
50430,53,3410,53,789,102,687,2,30,1,1
55705,53,14171,53,209,110,99,2,30,1,1
64185,445,0,0,70,70,0,1,0,1,0
56221,443,24462,443,129824,16359,113465,185,459,79,106
55344,53,62039,53,212,110,102,2,30,1,1
58776,443,47713,443,3991,2587,1404,17,16,9,8
56288,53,30293,53,183,94,89,2,30,1,1
9068,443,2083,443,5045,2005,3040,14,119,7,7
52472,7302,0,0,66,66,0,1,0,1,0
49439,445,0,0,66,66,0,1,0,1,0
49451,443,37319,443,1855625,57182,1798443,1981,70,703,1278
49843,53,43292,53,193,102,91,2,30,1,1
64631,445,0,0,70,70,0,1,0,1,0
9518,443,46388,443,3613,433,3180,11,16,6,5
56100,53,56100,53,265,111,154,2,30,1,1
54136,443,41489,443,10109,1394,8715,22,75,13,9
1487,35440,0,0,146,146,0,1,0,1,0
64563,445,0,0,70,70,0,1,0,1,0
56710,53,63295,53,193,94,99,2,29,1,1
44443,80,37663,80,1114,534,580,12,16,7,5
3478,61463,0,0,455,455,0,1,0,1,0
49854,80,32743,80,14603,5117,9486,24,89,12,12
58638,5900,0,0,62,62,0,1,0,1,0
0,0,0,0,480,244,236,4,0,2,2
49480,80,65349,80,6811,3791,3020,23,115,13,10
65007,53,49517,53,330,94,236,4,55,2,2
57069,53,52685,53,177,94,83,2,31,1,1
443,35385,0,0,66,66,0,1,0,1,0
49253,53,44015,53,199,102,97,2,30,1,1
30945,53,30945,53,237,91,146,2,32,1,1
62413,6881,56796,6881,311,311,0,3,1200,3,0
54178,445,0,0,70,70,0,1,0,1,0
57275,443,6369,443,22074,3005,19069,58,31,31,27
7811,44847,0,0,62,62,0,1,0,1,0
61818,80,36349,80,4454,591,3863,12,45,6,6
14615,57866,0,0,66,66,0,1,0,1,0
43155,35440,0,0,66,66,0,1,0,1,0
56445,53,19322,53,374,94,280,2,30,1,1
49144,443,40050,443,130,70,60,3,5,2,1
52042,38074,53103,38074,70,70,0,2,8,2,0
50890,80,12548,80,290951,15209,275742,327,141,132,195
50412,445,0,0,66,66,0,1,0,1,0
64947,53,61833,53,275,96,179,4,41,2,2
62278,445,0,0,70,70,0,1,0,1,0
56773,80,16432,80,1462,703,759,8,16,5,3
56696,445,0,0,70,70,0,1,0,1,0
61319,445,0,0,66,66,0,1,0,1,0
64973,53,14211,53,210,102,108,2,30,1,1
49607,80,52438,80,378,192,186,7,41,4,3
52740,443,65500,443,168753,7954,160799,212,26,95,117
55788,53,13740,53,755,93,662,2,31,1,1
64989,53,11063,53,578,286,292,9,15,5,4
2598,23718,0,0,62,62,0,1,0,1,0
61937,445,0,0,70,70,0,1,0,1,0
59891,53,0,0,248,75,173,2,30,1,1
56850,53,62960,53,763,101,662,2,31,1,1
51859,7700,19893,7700,8425,6015,2410,73,34,37,36
50265,42698,16471,42698,726,726,0,12,1200,12,0
49677,445,0,0,70,70,0,1,0,1,0
49256,445,0,0,70,70,0,1,0,1,0
55133,53,7400,53,711,87,624,2,30,1,1
52001,12514,64945,12514,70,70,0,2,7,2,0
49365,53,34232,53,199,94,105,2,31,1,1
52035,36498,46508,36498,70,70,0,2,9,2,0
60984,443,58411,443,12163,4876,7287,35,50,20,15
49331,445,0,0,66,66,0,1,0,1,0
55039,53,21186,53,177,94,83,2,30,1,1
64016,25174,0,0,62,62,0,1,0,1,0
49792,443,37527,443,9841,3185,6656,25,186,14,11
34173,53,34173,53,240,98,142,2,29,1,1
39094,443,9909,443,350650,19028,331622,494,83,251,243
37923,443,39242,443,2593394,70243,2523151,2678,303,908,1770
49763,53,30741,53,258,110,148,2,30,1,1
60203,53,37285,53,328,86,242,2,30,1,1
80,56289,0,0,578,578,0,1,0,1,0
60875,56205,0,0,66,66,0,1,0,1,0
56937,8200,55532,8200,78,78,0,1,30,1,0
64030,445,0,0,70,70,0,1,0,1,0
51667,443,62904,443,1203,703,500,14,42,8,6
63696,445,0,0,70,70,0,1,0,1,0
45470,443,49980,443,1636,827,809,18,43,10,8
53984,445,0,0,70,70,0,1,0,1,0
64114,53,0,0,200,90,110,2,30,1,1
45210,443,36516,443,1699,1038,661,16,276,9,7
64950,53,22680,53,182,93,89,2,31,1,1
50265,445,0,0,70,70,0,1,0,1,0
58638,5900,0,0,62,62,0,1,0,1,0
49907,53,29279,53,308,92,216,2,30,1,1
56221,53,31091,53,177,94,83,2,29,1,1
53799,6881,35241,6881,70,70,0,2,7,2,0
58295,445,0,0,70,70,0,1,0,1,0
55000,443,57257,443,16063,2691,13372,38,38,18,20
53831,53,28587,53,260,86,174,2,30,1,1
55656,53,30150,53,413,102,311,2,30,1,1
64251,53,51222,53,170,87,83,2,31,1,1
443,44683,0,0,83,83,0,1,0,1,0
55454,53,60200,53,202,103,99,2,31,1,1
443,14315,0,0,158,158,0,1,0,1,0
20457,51185,0,0,72,72,0,1,0,1,0
55044,445,0,0,70,70,0,1,0,1,0
28124,8497,0,0,148,148,0,1,0,1,0
41343,443,31271,443,7601,1595,6006,25,35,12,13
56869,17637,0,0,66,66,0,1,0,1,0
56759,53,4446,53,177,94,83,2,30,1,1
63899,62015,4677,62015,66,66,0,2,8,2,0
58638,5900,0,0,62,62,0,1,0,1,0
51900,15755,25086,15755,316,136,180,6,6,3,3
50553,3389,50553,3389,3327,1438,1889,15,17,8,7
65233,445,0,0,70,70,0,1,0,1,0
44481,443,29524,443,6336,1633,4703,22,256,12,10
51738,7000,51738,7000,3550,1983,1567,15,16,8,7
56800,23,0,0,60,60,0,1,0,1,0
59782,26467,0,0,62,62,0,1,0,1,0
37965,21859,39298,21859,481,150,331,2,1199,1,1
59923,53,7241,53,197,78,119,2,30,1,1
64077,25174,0,0,62,62,0,1,0,1,0
50244,80,52530,80,136475,59298,77177,166,53,78,88
48817,51413,48817,51413,485,158,327,2,1199,1,1
53580,48066,12026,48066,70,70,0,1,5,1,0
55577,53,47306,53,199,102,97,2,30,1,1
20389,64147,0,0,66,66,0,1,0,1,0
56480,53,53765,53,755,94,661,2,31,1,1
55323,445,0,0,70,70,0,1,0,1,0
63932,445,0,0,66,66,0,1,0,1,0
12128,37965,0,0,62,62,0,1,0,1,0
49456,445,0,0,66,66,0,1,0,1,0
33257,443,43255,443,19341,4612,14729,38,21,19,19
64989,53,60666,53,214,102,112,2,30,1,1
65019,53,36796,53,195,102,93,2,30,1,1
47893,443,63291,443,172,172,0,2,4,2,0
49376,53,19245,53,209,110,99,2,30,1,1
58832,445,0,0,70,70,0,1,0,1,0
57570,443,12758,443,21267,5407,15860,36,361,17,19
49623,53,34250,53,790,110,680,2,29,1,1
57321,53,25115,53,498,204,294,6,29,3,3
54737,50584,0,0,66,66,0,1,0,1,0
38834,53,64506,53,168,78,90,2,30,1,1
65196,53,54719,53,392,90,302,4,55,2,2
49558,53,30601,53,184,94,90,2,30,1,1
1108,47807,0,0,159,159,0,1,0,1,0
59279,80,59279,80,108786,4563,104223,192,16,65,127
51788,35787,52462,35787,70,70,0,2,8,2,0
52034,48856,38527,48856,66,66,0,1,5,1,0
55746,445,0,0,70,70,0,1,0,1,0
59161,445,0,0,70,70,0,1,0,1,0
65323,53,33275,53,356,118,238,2,30,1,1
59803,445,0,0,66,66,0,1,0,1,0
40845,53,40845,53,210,98,112,2,31,1,1
57296,53,45722,53,200,102,98,2,30,1,1
27005,27015,35469,27015,886,126,760,2,30,1,1
55601,44049,44869,44049,504,318,186,8,15,5,3
55760,53,53617,53,180,92,88,2,31,1,1
61019,445,0,0,66,66,0,1,0,1,0
20608,28189,0,0,60,60,0,1,0,1,0
60411,445,0,0,70,70,0,1,0,1,0
37427,443,40807,443,26069,12062,14007,46,123,21,25
10874,25174,0,0,62,62,0,1,0,1,0
53323,35253,0,0,62,62,0,1,0,1,0
57880,53,57880,53,231,97,134,2,30,1,1
62516,445,0,0,70,70,0,1,0,1,0
49644,30188,0,0,62,62,0,1,0,1,0
57140,445,0,0,66,66,0,1,0,1,0
53839,15000,61295,15000,130,70,60,2,5,1,1
49931,443,64224,443,92352,5699,86653,105,134,35,70
41763,443,59315,443,9797,1934,7863,21,15,12,9
56929,53,55156,53,784,94,690,2,30,1,1
51071,445,0,0,70,70,0,1,0,1,0
2267,53,56692,53,204,118,86,2,30,1,1
6881,57470,0,0,146,146,0,1,0,1,0
64618,445,0,0,70,70,0,1,0,1,0
54194,443,16208,443,499,425,74,4,0,3,1
64007,445,0,0,70,70,0,1,0,1,0
43888,64147,0,0,62,62,0,1,0,1,0
65189,27237,9524,27237,234,78,156,2,30,1,1
64939,445,0,0,70,70,0,1,0,1,0
64335,53,18778,53,186,95,91,2,30,1,1
56327,53,21642,53,178,94,84,2,29,1,1
52869,445,0,0,70,70,0,1,0,1,0
38815,53,38815,53,230,99,131,2,30,1,1
56896,80,32594,80,2684,2550,134,7,16,5,2
63945,445,0,0,70,70,0,1,0,1,0
56727,53,4531,53,250,86,164,4,46,2,2
64689,53,34039,53,183,94,89,2,30,1,1
65101,53,61768,53,402,118,284,2,30,1,1
54828,443,7869,443,150,150,0,1,5,1,0
26943,443,22865,443,21275,16156,5119,41,22,23,18
60909,445,0,0,70,70,0,1,0,1,0
56658,53,26187,53,193,102,91,2,30,1,1
57900,443,44556,443,1798,1159,639,17,170,10,7
63807,445,0,0,70,70,0,1,0,1,0
36144,443,36144,443,170890,13800,157090,246,97,123,123
55229,53,8520,53,173,94,79,2,30,1,1
59350,443,59350,443,4401,1494,2907,19,27,11,8
58638,5900,0,0,62,62,0,1,0,1,0
3937,36829,0,0,62,62,0,1,0,1,0
52169,59681,49857,59681,66,66,0,1,5,1,0
56568,443,49242,443,1277,705,572,13,25,7,6
49562,53,28687,53,198,94,104,2,30,1,1
53464,443,61601,443,6550,1555,4995,25,53,13,12
58209,53,48023,53,259,86,173,2,30,1,1
55749,37965,0,0,66,66,0,1,0,1,0
55043,443,10001,443,36707,3750,32957,54,60,24,30
64634,53,6012,53,211,102,109,2,29,1,1
51964,1103,26830,1103,70,70,0,1,4,1,0
1025,50584,0,0,146,146,0,1,0,1,0
63049,443,56063,443,384,166,218,2,30,1,1
53886,443,35805,443,6074,1579,4495,18,125,11,7
53665,80,59537,80,4417,3685,732,16,15,10,6
51311,445,0,0,66,66,0,1,0,1,0
58600,443,58600,443,4396,1489,2907,19,26,11,8
42298,40002,11642,40002,724,550,174,4,30,2,2
61637,53,50085,53,246,246,0,4,47,4,0
51969,37558,33450,37558,70,70,0,1,4,1,0
56750,53,18998,53,279,118,161,2,30,1,1
64862,53,5762,53,211,110,101,2,30,1,1
58638,5900,0,0,62,62,0,1,0,1,0
37542,443,40273,443,13299,2872,10427,34,41,19,15
49940,53,16387,53,257,110,147,2,29,1,1
37617,443,47875,443,499,425,74,4,0,3,1
55966,445,0,0,70,70,0,1,0,1,0
0,0,0,0,134,64,70,2,0,1,1
42936,53,47625,53,199,94,105,2,30,1,1
49816,443,49816,443,4682,1775,2907,19,28,11,8
49690,53,62022,53,322,110,212,4,30,2,2
56655,80,36577,80,234,234,0,4,12,4,0
37429,25174,0,0,62,62,0,1,0,1,0
11488,22114,0,0,62,62,0,1,0,1,0
41852,35440,0,0,62,62,0,1,0,1,0
53787,1,62839,1,320,140,180,6,6,3,3
53193,443,17954,443,1462,965,497,13,18,7,6
65059,445,0,0,70,70,0,1,0,1,0
51382,56205,0,0,66,66,0,1,0,1,0
51414,22,0,0,60,60,0,1,0,1,0
29203,26467,0,0,62,62,0,1,0,1,0
56640,445,0,0,70,70,0,1,0,1,0
56375,53,31585,53,177,94,83,2,31,1,1
60805,5900,0,0,60,60,0,1,0,1,0
55635,53,13643,53,177,94,83,2,30,1,1
52526,30188,0,0,66,66,0,1,0,1,0
65485,53,26681,53,184,94,90,2,29,1,1
51913,443,46255,443,13337,10008,3329,47,185,23,24
24260,50584,0,0,62,62,0,1,0,1,0
51231,443,1331,443,1396,735,661,14,80,8,6
49418,27018,39364,27018,247,78,169,2,30,1,1
39472,443,61496,443,9767,2138,7629,22,16,12,10
51192,15503,0,0,66,66,0,1,0,1,0
59549,50584,0,0,66,66,0,1,0,1,0
49544,80,16588,80,10192,3818,6374,20,16,9,11
49628,53,48622,53,168,86,82,2,31,1,1
50191,445,0,0,70,70,0,1,0,1,0
6455,80,6455,80,326,186,140,6,29,4,2
53173,445,0,0,66,66,0,1,0,1,0
51414,22,0,0,60,60,0,1,0,1,0
56117,53,31292,53,172,88,84,2,31,1,1
63804,445,0,0,66,66,0,1,0,1,0
62973,445,0,0,70,70,0,1,0,1,0
63904,445,0,0,66,66,0,1,0,1,0
60350,51505,0,0,66,66,0,1,0,1,0
51088,443,60075,443,14025,7301,6724,38,171,22,16
39230,23,0,0,60,60,0,1,0,1,0
15180,26467,0,0,62,62,0,1,0,1,0
58287,445,0,0,70,70,0,1,0,1,0
55123,53,64230,53,196,100,96,2,31,1,1
57382,53,15348,53,969,86,883,2,30,1,1
6121,51505,0,0,66,66,0,1,0,1,0
59051,27520,0,0,62,62,0,1,0,1,0
55237,53,51535,53,259,87,172,4,56,2,2
44681,31573,0,0,146,146,0,1,0,1,0
42153,443,25509,443,12306,2097,10209,31,360,15,16
56262,53,24636,53,177,94,83,2,30,1,1
49582,445,0,0,66,66,0,1,0,1,0
50350,445,0,0,70,70,0,1,0,1,0
41246,443,27215,443,234,234,0,4,12,4,0
38279,80,49834,80,122,62,60,2,15,1,1
49987,443,39263,443,426,180,246,8,21,4,4
49984,53,7504,53,178,94,84,2,30,1,1
59917,445,0,0,70,70,0,1,0,1,0
9745,26467,0,0,62,62,0,1,0,1,0
54270,445,0,0,70,70,0,1,0,1,0
53522,24116,50290,24116,70,70,0,1,4,1,0
27005,27015,55780,27015,873,126,747,3,31,2,1
55125,53,47085,53,177,94,83,2,30,1,1
49290,53,14935,53,184,94,90,2,31,1,1
58638,5900,0,0,62,62,0,1,0,1,0
27005,27015,2437,27015,878,126,752,2,30,1,1
53939,9504,53453,9504,492,306,186,8,15,5,3
41611,80,9523,80,1860,712,1148,8,15,5,3
30654,51221,0,0,72,72,0,1,0,1,0
53771,37965,0,0,66,66,0,1,0,1,0
49790,53,8407,53,229,110,119,2,30,1,1
57233,50934,0,0,66,66,0,1,0,1,0
52891,443,27899,443,320255,9207,311048,343,117,107,236
53146,50393,21783,50393,70,70,0,2,8,2,0
60075,445,0,0,66,66,0,1,0,1,0
63200,445,0,0,66,66,0,1,0,1,0
50105,53,29739,53,969,86,883,2,30,1,1
56127,37965,0,0,66,66,0,1,0,1,0
40050,53,42804,53,168,78,90,2,30,1,1
55713,47783,7321,47783,70,70,0,2,8,2,0
52245,445,0,0,70,70,0,1,0,1,0
44922,443,33552,443,5578,764,4814,14,15,8,6
60612,443,17628,443,117190,11380,105810,171,212,67,104
58874,443,12303,443,10630,6981,3649,31,17,17,14
49073,443,18222,443,8960,2497,6463,35,32,19,16
55691,16410,58376,16410,70,70,0,2,8,2,0
37203,443,4528,443,466,392,74,4,0,3,1
56624,445,0,0,70,70,0,1,0,1,0
47932,443,21603,443,9467,2741,6726,24,20,15,9
56725,443,7873,443,6481,972,5509,17,52,10,7
52086,80,55343,80,2703,632,2071,12,22,7,5
56991,53,36997,53,748,106,642,2,30,1,1
50739,445,0,0,66,66,0,1,0,1,0
57131,35776,0,0,145,145,0,1,0,1,0
53258,445,0,0,66,66,0,1,0,1,0
37335,443,14228,443,130,70,60,3,5,2,1
61845,11392,0,0,62,62,0,1,0,1,0
53556,1024,47936,1024,70,70,0,1,4,1,0
65166,62413,0,0,66,66,0,1,0,1,0
63103,53,6941,53,222,86,136,2,30,1,1
49628,443,14591,443,12843,3808,9035,26,81,13,13
65053,53,65053,53,235,90,145,2,31,1,1
63738,443,63738,443,4349,1442,2907,19,27,11,8
65355,53,46648,53,592,105,487,4,50,2,2
52002,80,8270,80,7480,4670,2810,47,324,30,17
53705,30600,18470,30600,492,306,186,8,15,5,3
40082,22,0,0,60,60,0,1,0,1,0
60632,445,0,0,66,66,0,1,0,1,0
55969,53,43128,53,731,91,640,2,31,1,1
61694,443,25571,443,8696,3245,5451,36,47,16,20
24351,57470,0,0,62,62,0,1,0,1,0
58638,5900,0,0,62,62,0,1,0,1,0
51605,443,55829,443,8095,3030,5065,27,95,14,13
63751,445,0,0,70,70,0,1,0,1,0
47944,50584,0,0,62,62,0,1,0,1,0
58638,5900,0,0,62,62,0,1,0,1,0
15333,44847,0,0,62,62,0,1,0,1,0
49156,53,9695,53,190,97,93,2,30,1,1
48430,22,0,0,60,60,0,1,0,1,0
51397,445,0,0,70,70,0,1,0,1,0
34891,53,37025,53,396,257,139,3,30,2,1
64290,53,4374,53,196,102,94,2,30,1,1
56377,51505,0,0,66,66,0,1,0,1,0
51950,80,41291,80,1268,645,623,12,45,7,5
56710,53,40167,53,195,102,93,2,31,1,1
17027,1,0,0,62,62,0,1,0,1,0
55396,443,55396,443,63319,6716,56603,91,19,45,46
12929,41864,0,0,145,145,0,1,0,1,0
49882,53,52287,53,441,104,337,4,48,2,2
49418,27016,30078,27016,78,78,0,1,30,1,0
49288,443,9666,443,7846,2369,5477,23,385,10,13
38885,21247,0,0,62,62,0,1,0,1,0
2475,6881,0,0,66,66,0,1,0,1,0
57363,53,22472,53,178,94,84,2,30,1,1
28139,22114,0,0,62,62,0,1,0,1,0
57767,445,0,0,70,70,0,1,0,1,0
55712,53,52427,53,164,86,78,2,29,1,1
59609,443,2759,443,7762,1777,5985,22,80,13,9
6661,23,0,0,60,60,0,1,0,1,0
59012,445,0,0,70,70,0,1,0,1,0
64204,53,35802,53,193,102,91,2,30,1,1
57299,53,60240,53,338,110,228,2,30,1,1
60691,445,0,0,66,66,0,1,0,1,0
46167,80,23731,80,234,234,0,4,11,4,0
64574,443,40988,443,9151,2109,7042,27,30,15,12
51440,445,0,0,66,66,0,1,0,1,0
65460,53,26483,53,197,102,95,2,30,1,1
50419,26467,0,0,66,66,0,1,0,1,0
65370,53,4186,53,778,103,675,2,31,1,1
3023,40108,0,0,148,148,0,1,0,1,0
53495,445,0,0,66,66,0,1,0,1,0
55542,443,51637,443,58975,3359,55616,78,26,34,44
65313,445,0,0,70,70,0,1,0,1,0
57305,53,52868,53,168,86,82,2,29,1,1
26461,80,26461,80,490,264,226,8,32,5,3
55107,53,25498,53,184,94,90,2,30,1,1
64997,51221,0,0,66,66,0,1,0,1,0
58972,80,64079,80,943,513,430,9,14,6,3
443,47582,0,0,85,85,0,1,0,1,0
58096,445,0,0,70,70,0,1,0,1,0
54677,443,30863,443,72676,12694,59982,144,127,64,80
35615,443,10957,443,6179,1242,4937,22,42,11,11
64149,53,35596,53,301,108,193,4,50,2,2
53802,59932,27956,59932,320,140,180,6,6,3,3
49364,53,20144,53,183,94,89,2,30,1,1
56468,53,3693,53,180,94,86,2,30,1,1
55770,53,9659,53,177,94,83,2,30,1,1
51229,443,49748,443,8590,1038,7552,16,120,7,9
64730,53,5756,53,261,94,167,2,30,1,1
57545,445,0,0,66,66,0,1,0,1,0
42640,11119,0,0,148,148,0,1,0,1,0
43309,80,55504,80,805,665,140,6,32,4,2
51114,25174,0,0,66,66,0,1,0,1,0
50265,26512,31440,26512,480,149,331,2,1200,1,1
64332,53,46508,53,167,86,81,2,30,1,1
65309,53,31055,53,764,102,662,2,30,1,1
49128,443,6577,443,3062,1747,1315,17,16,9,8
51676,23718,0,0,66,66,0,1,0,1,0
59961,445,0,0,70,70,0,1,0,1,0
32051,37965,0,0,62,62,0,1,0,1,0
63317,53,0,0,181,86,95,2,30,1,1
60322,443,12700,443,1743,1164,579,16,25,10,6
64137,53,46613,53,276,126,150,2,30,1,1
55061,443,38247,443,18682,8068,10614,42,62,22,20
53565,58695,4400,58695,70,70,0,1,5,1,0
50487,445,0,0,70,70,0,1,0,1,0
49420,53,61159,53,183,94,89,2,30,1,1
53627,445,0,0,66,66,0,1,0,1,0
54777,445,0,0,70,70,0,1,0,1,0
55581,64301,29198,64301,316,190,126,5,15,3,2
57270,53,53677,53,200,102,98,2,31,1,1
57071,53,59373,53,166,86,80,2,30,1,1
51999,37965,0,0,62,62,0,1,0,1,0
49591,5228,57295,5228,18548,2772,15776,41,3957,17,24
49493,53,48045,53,241,118,123,2,30,1,1
48817,11373,48817,11373,481,150,331,2,1200,1,1
53462,443,47212,443,6384,1091,5293,18,30,10,8
49602,445,0,0,70,70,0,1,0,1,0
56837,53,4890,53,195,102,93,2,29,1,1
57729,19750,0,0,66,66,0,1,0,1,0
65394,53,54686,53,230,94,136,2,30,1,1
60241,443,3002,443,92975,3289,89686,107,316,40,67
35749,18375,0,0,146,146,0,1,0,1,0
63004,445,0,0,70,70,0,1,0,1,0
48908,53,48908,53,398,255,143,3,32,2,1
58877,443,18145,443,2577,1550,1027,15,15,7,8
59883,445,0,0,70,70,0,1,0,1,0
58638,5900,0,0,62,62,0,1,0,1,0
56081,53,45307,53,237,94,143,2,29,1,1
56940,53,50066,53,200,102,98,2,30,1,1
27005,27015,38392,27015,878,126,752,2,30,1,1
52010,80,6411,80,1327,822,505,11,21,7,4
53719,443,54352,443,3225,1939,1286,26,139,14,12
53352,445,0,0,70,70,0,1,0,1,0
64212,53,41326,53,215,102,113,2,30,1,1
40369,57470,0,0,62,62,0,1,0,1,0
60584,445,0,0,66,66,0,1,0,1,0
60246,44612,0,0,66,66,0,1,0,1,0
49825,53,56726,53,168,86,82,2,30,1,1
57295,53,34997,53,448,184,264,6,30,3,3
64023,53,57287,53,179,94,85,2,30,1,1
63572,443,58406,443,125798,40014,85784,276,171,125,151
53938,445,0,0,70,70,0,1,0,1,0
5588,5588,0,0,3354,1792,1562,46,196,23,23
39387,443,57166,443,204,70,134,4,26,2,2
44133,53,62526,53,164,78,86,2,30,1,1
63081,53,24594,53,304,86,218,2,30,1,1
42873,443,33511,443,3379,2111,1268,19,15,10,9
61701,80,22637,80,1495,954,541,13,47,8,5
49884,445,0,0,70,70,0,1,0,1,0
38018,443,11782,443,1851,1222,629,16,27,10,6
52085,80,49733,80,360,240,120,7,25,5,2
64787,53,33533,53,179,94,85,2,30,1,1
61464,80,54948,80,366,180,186,7,93,4,3
64937,53,49091,53,94,94,0,1,30,1,0
55300,53,49492,53,308,94,214,2,30,1,1
61838,37965,0,0,62,62,0,1,0,1,0
62251,445,0,0,70,70,0,1,0,1,0
49308,53,0,0,627,80,547,2,29,1,1
50131,445,0,0,70,70,0,1,0,1,0
49416,53,16616,53,185,102,83,2,30,1,1
57557,64147,0,0,66,66,0,1,0,1,0
62550,51505,0,0,62,62,0,1,0,1,0
55349,53,40115,53,701,88,613,2,31,1,1
55704,53,8827,53,177,94,83,2,31,1,1
49754,80,3257,80,1793,634,1159,11,15,6,5
23969,57470,0,0,62,62,0,1,0,1,0
49753,445,0,0,70,70,0,1,0,1,0
50418,445,0,0,66,66,0,1,0,1,0
57326,443,4725,443,5613,733,4880,16,14,9,7
58638,5900,0,0,62,62,0,1,0,1,0
33965,443,58848,443,31008,10449,20559,69,130,31,38
443,43775,0,0,97,97,0,1,0,1,0
49682,443,37715,443,9766,1633,8133,27,172,13,14
64908,53,55022,53,232,94,138,2,30,1,1
56970,53,18773,53,230,110,120,2,30,1,1
65433,445,0,0,66,66,0,1,0,1,0
54774,445,0,0,70,70,0,1,0,1,0
27005,33056,50628,33056,885,126,759,2,31,1,1
60855,445,0,0,70,70,0,1,0,1,0
49943,80,26149,80,10767,783,9984,19,15,9,10
57503,445,0,0,66,66,0,1,0,1,0
41460,443,23165,443,13890,5926,7964,36,84,20,16
53038,445,0,0,66,66,0,1,0,1,0
9190,443,45715,443,4943,429,4514,12,15,6,6
62774,445,0,0,66,66,0,1,0,1,0
11859,64147,0,0,62,62,0,1,0,1,0
56832,445,0,0,70,70,0,1,0,1,0
57162,445,0,0,66,66,0,1,0,1,0
32770,51505,0,0,62,62,0,1,0,1,0
55338,11744,0,0,145,145,0,1,0,1,0
64567,443,24686,443,24984,2042,22942,41,32,19,22
50103,53,41648,53,168,86,82,2,31,1,1
22683,39210,0,0,60,60,0,1,0,1,0
50016,53,14072,53,766,103,663,4,41,2,2
41064,80,41064,80,2118,1493,625,9,82,6,3
50900,80,32944,80,14423569,189925,14233644,12194,135,2586,9608
49665,80,35482,80,8457,3062,5395,16,41,7,9
62929,443,8515,443,46033,7524,38509,103,141,49,54
6881,6881,10552,6881,238,118,120,2,1200,1,1
57095,53,7010,53,177,94,83,2,30,1,1
50068,445,0,0,66,66,0,1,0,1,0
56596,53,51860,53,199,102,97,2,30,1,1
59086,53,59086,53,235,90,145,2,32,1,1
1936,80,29393,80,214,140,74,4,15,3,1
56552,53,3851,53,195,102,93,2,31,1,1
6881,45711,37473,45711,228,118,110,2,1199,1,1
59457,53,59457,53,213,87,126,2,30,1,1
55962,53,39113,53,186,95,91,2,31,1,1
58206,445,0,0,66,66,0,1,0,1,0
51831,26270,32908,26270,70,70,0,2,6,2,0
65482,445,0,0,70,70,0,1,0,1,0
52624,445,0,0,70,70,0,1,0,1,0
64804,445,0,0,66,66,0,1,0,1,0
60346,80,8391,80,2124,1158,966,13,87,7,6
10319,42707,0,0,62,62,0,1,0,1,0
54527,443,27649,443,13132,7107,6025,45,174,23,22
56774,39553,10646,39553,70,70,0,2,8,2,0
46484,22,46484,22,7922,3413,4509,55,38,26,29
26324,30188,0,0,62,62,0,1,0,1,0
6881,6882,26617,6882,231,111,120,2,1200,1,1
57192,53,42489,53,177,94,83,2,30,1,1
6881,8305,0,0,143,143,0,1,0,1,0
64695,53,9580,53,186,95,91,2,31,1,1
49671,53,15823,53,166,86,80,2,29,1,1
59378,50584,0,0,66,66,0,1,0,1,0
14614,25174,0,0,66,66,0,1,0,1,0
49758,443,14307,443,17412,6917,10495,38,63,20,18
11362,64147,0,0,145,145,0,1,0,1,0
43111,443,29874,443,3117,1867,1250,19,15,9,10
64123,445,0,0,70,70,0,1,0,1,0
49208,53,22620,53,578,286,292,9,15,5,4
56259,445,0,0,70,70,0,1,0,1,0
53737,443,15661,443,499,425,74,4,0,3,1
62825,443,8189,443,17772,2595,15177,25,122,12,13
58556,80,23584,80,884,529,355,10,255,6,4
33388,53,33388,53,229,98,131,2,30,1,1
60760,20010,54790,20010,70,70,0,2,8,2,0
56492,53,12334,53,184,94,90,2,29,1,1
60098,445,0,0,66,66,0,1,0,1,0
50478,445,0,0,66,66,0,1,0,1,0
55799,445,0,0,70,70,0,1,0,1,0
59397,445,0,0,70,70,0,1,0,1,0
61189,443,61189,443,1092,645,447,10,34,6,4
56891,53,21983,53,200,94,106,2,30,1,1
55830,53,60660,53,182,93,89,2,31,1,1
40500,25356,0,0,146,146,0,1,0,1,0
29178,35440,0,0,66,66,0,1,0,1,0
47650,443,28162,443,1056,569,487,10,24,6,4
49308,443,39770,443,4256,2975,1281,23,47,12,11
54866,37965,0,0,62,62,0,1,0,1,0
54797,445,0,0,70,70,0,1,0,1,0
56951,53,51481,53,250,86,164,4,31,2,2
62408,3478,62290,3478,140,140,0,1,30,1,0
65531,53,44923,53,193,102,91,2,30,1,1
55364,53,21776,53,168,86,82,2,31,1,1
40590,443,36504,443,2965,1650,1315,24,275,12,12
58638,5900,0,0,62,62,0,1,0,1,0
53720,443,24279,443,499,425,74,4,0,3,1
52847,53,50629,53,86,86,0,1,30,1,0
13235,44847,0,0,66,66,0,1,0,1,0
63988,50584,0,0,62,62,0,1,0,1,0
53591,35889,63951,35889,320,140,180,6,6,3,3
42025,443,40368,443,2394,1365,1029,18,275,9,9
26560,26467,0,0,66,66,0,1,0,1,0
56674,443,42391,443,7889,1900,5989,20,15,11,9
49182,53,44371,53,211,102,109,2,30,1,1
59993,445,0,0,70,70,0,1,0,1,0
62007,24184,0,0,66,66,0,1,91,1,0
55020,445,0,0,70,70,0,1,0,1,0
56496,53,21788,53,164,86,78,2,30,1,1
52396,443,30033,443,1253628,61672,1191956,1875,220,939,936
56481,443,31113,443,1853,1214,639,18,134,11,7
36679,443,65477,443,466,392,74,4,0,3,1
56403,445,0,0,70,70,0,1,0,1,0
57470,3800,54639,3800,150,150,0,1,1199,1,0
49159,53,5839,53,195,86,109,2,30,1,1
65008,53,8162,53,312,94,218,2,30,1,1
65315,445,0,0,70,70,0,1,0,1,0
63800,80,60637,80,314,192,122,6,15,4,2
62325,443,62325,443,1210,637,573,14,51,7,7
50537,445,0,0,66,66,0,1,0,1,0
6666,2222,0,0,60,60,0,1,0,1,0
50166,80,59884,80,2181,849,1332,14,97,7,7
63273,445,0,0,70,70,0,1,0,1,0
51575,445,0,0,66,66,0,1,0,1,0
51575,9694,0,0,66,66,0,1,0,1,0
56482,445,0,0,70,70,0,1,0,1,0
55134,53,55134,53,825,99,726,2,31,1,1
19875,30170,0,0,145,145,0,1,0,1,0
56923,53,49262,53,711,87,624,2,30,1,1
62643,445,0,0,66,66,0,1,0,1,0
51690,80,52942,80,21064,2772,18292,38,175,18,20
49500,53,31434,53,248,118,130,2,29,1,1
64089,53,43918,53,340,96,244,4,35,2,2
49574,53,12004,53,337,110,227,2,30,1,1
49323,53,40976,53,196,102,94,2,31,1,1
36515,80,38433,80,51571,48786,2785,74,19,38,36
30169,35776,0,0,159,159,0,1,0,1,0
52066,80,29968,80,692,300,392,9,26,6,3
64575,443,61163,443,24686,1935,22751,36,16,17,19
49223,443,17029,443,14838,6995,7843,52,244,26,26
63254,445,0,0,70,70,0,1,0,1,0
65487,53,56832,53,210,110,100,2,30,1,1
49284,53,32626,53,245,102,143,2,29,1,1
10006,64147,0,0,62,62,0,1,0,1,0
60419,53,60419,53,217,87,130,2,30,1,1
64887,445,0,0,66,66,0,1,0,1,0
6890,27520,0,0,146,146,0,1,0,1,0
56694,443,2147,443,3723,2372,1351,18,18,10,8
58574,445,0,0,70,70,0,1,0,1,0
50584,6881,48204,6881,161,161,0,1,1200,1,0
34957,80,4367,80,7136,3526,3610,42,1239,21,21
46901,26672,0,0,60,60,0,1,0,1,0
55012,443,43376,443,7249,1797,5452,29,32,17,12
47971,443,21107,443,9021,1511,7510,21,121,11,10
61840,25174,0,0,66,66,0,1,0,1,0
1694,30188,0,0,62,62,0,1,0,1,0
26900,27017,15895,27017,254,82,172,4,30,2,2
51382,56205,0,0,66,66,0,1,0,1,0
57643,28189,0,0,60,60,0,1,0,1,0
26802,50584,0,0,62,62,0,1,0,1,0
41861,5223,49797,5223,5169,1103,4066,26,214,10,16
80,53945,0,0,60,60,0,1,0,1,0
58972,57866,0,0,62,62,0,1,0,1,0
56167,53,49116,53,178,94,84,2,30,1,1
12531,22114,0,0,62,62,0,1,0,1,0
52459,5555,0,0,60,60,0,1,0,1,0
53124,443,13902,443,7459,2962,4497,24,47,14,10
23383,64147,0,0,62,62,0,1,0,1,0
56618,80,46340,80,234,234,0,4,12,4,0
55492,53,58378,53,760,96,664,2,31,1,1
55014,53,9068,53,716,95,621,2,31,1,1
65133,53,55111,53,198,102,96,2,30,1,1
58638,5900,0,0,62,62,0,1,0,1,0
443,28553,0,0,74,74,0,1,0,1,0
50868,445,0,0,66,66,0,1,0,1,0
53751,443,64587,443,61501,14276,47225,91,35,39,52
49969,445,0,0,70,70,0,1,0,1,0
58638,5900,0,0,62,62,0,1,0,1,0
58638,5900,0,0,62,62,0,1,0,1,0
51444,443,44166,443,7658,1309,6349,24,75,13,11
47196,443,63403,443,2701330,44089,2657241,2230,134,296,1934
52916,443,43880,443,5455,1388,4067,17,15,9,8
56479,443,37707,443,3041,1995,1046,17,16,8,9
47166,443,47166,443,4567,1660,2907,19,28,11,8
1114,37965,0,0,62,62,0,1,0,1,0
53129,80,16654,80,5318,685,4633,14,15,7,7
51094,35440,0,0,62,62,0,1,0,1,0
55269,53,18249,53,102,102,0,1,30,1,0
6817,23,0,0,60,60,0,1,0,1,0
50542,53,19780,53,762,98,664,2,30,1,1
60952,445,0,0,66,66,0,1,0,1,0
48098,80,19717,80,1638,1324,314,10,15,5,5
59328,445,0,0,66,66,0,1,0,1,0
2572,17546,0,0,66,66,0,1,0,1,0
56921,443,49898,443,8416,2142,6274,25,330,12,13
51694,80,56366,80,1307,649,658,8,75,5,3
52643,36237,0,0,66,66,0,1,0,1,0
64417,53,47310,53,369,94,275,4,49,2,2
52626,80,56571,80,2820,1466,1354,20,534,11,9
55055,80,30882,80,306,180,126,6,26,4,2
51645,80,57006,80,318,192,126,6,38,4,2
56094,445,0,0,66,66,0,1,0,1,0
49324,443,63452,443,6586,3686,2900,35,75,17,18
44117,6881,0,0,62,62,0,1,0,1,0
38708,443,36955,443,90166,3481,86685,96,15,31,65
27164,53,27164,53,208,94,114,2,30,1,1
50966,443,50616,443,17161,1619,15542,18,143,4,14
49626,443,38035,443,8266,1963,6303,28,175,14,14
56587,53,5530,53,184,94,90,2,31,1,1
53126,443,9290,443,5604,2738,2866,20,325,10,10
49160,44512,0,0,146,146,0,1,0,1,0
49883,53,42017,53,177,94,83,2,30,1,1
50710,443,41434,443,6141,1268,4873,22,18,12,10
52431,50265,0,0,62,62,0,1,0,1,0
14409,7363,0,0,145,145,0,1,0,1,0
53781,37965,0,0,66,66,0,1,0,1,0
49993,443,14877,443,14857,1138,13719,26,17,10,16
23126,35440,0,0,62,62,0,1,0,1,0
49254,53,34045,53,214,102,112,2,30,1,1
60014,443,21323,443,10021,3035,6986,30,46,17,13
50579,80,48781,80,265114,13651,251463,346,76,161,185
27005,27017,1737,27017,891,126,765,2,30,1,1
3800,5223,0,0,146,146,0,1,0,1,0
52240,445,0,0,70,70,0,1,0,1,0
64615,53,13915,53,386,134,252,2,30,1,1
27005,27016,24190,27016,1696,126,1570,4,31,2,2
65085,22114,0,0,66,66,0,1,0,1,0
56852,445,0,0,70,70,0,1,0,1,0
53140,443,26358,443,6401,1225,5176,18,324,9,9
52118,443,25040,443,22072,2166,19906,44,49,22,22
60466,445,0,0,70,70,0,1,0,1,0
38290,443,29490,443,6978,1169,5809,22,163,12,10
47668,443,3195,443,69732,65832,3900,104,316,55,49
65315,53,25956,53,172,88,84,2,30,1,1
55262,44847,0,0,62,62,0,1,0,1,0
57968,53,57968,53,371,237,134,3,32,2,1
11136,17500,0,0,145,145,0,1,0,1,0
52329,53,12571,53,294,86,208,2,30,1,1
60946,445,0,0,70,70,0,1,0,1,0
64169,445,0,0,70,70,0,1,0,1,0
64380,53,29472,53,186,95,91,2,31,1,1
53729,40721,59100,40721,70,70,0,2,8,2,0
57040,53,36140,53,179,94,85,2,31,1,1
9522,443,6233,443,6146,709,5437,18,29,8,10
57410,37965,0,0,66,66,0,1,0,1,0
57896,7635,57896,7635,138,78,60,2,5,1,1
53587,32029,40143,32029,70,70,0,1,5,1,0
53960,30041,0,0,62,62,0,1,0,1,0
49695,53,13184,53,772,103,669,2,31,1,1
60441,445,0,0,70,70,0,1,0,1,0
58396,443,53120,443,138065,109491,28574,429,186,230,199
45937,53,13210,53,241,78,163,2,30,1,1
65497,53,26978,53,197,102,95,2,30,1,1
56425,53,0,0,82,82,0,1,30,1,0
57588,443,14769,443,7629,3270,4359,34,337,17,17
50995,445,0,0,66,66,0,1,0,1,0
56365,80,15105,80,1636,699,937,10,15,5,5
58638,5900,0,0,62,62,0,1,0,1,0
48817,13073,48817,13073,787,296,491,4,1200,2,2
58638,5900,0,0,62,62,0,1,0,1,0
3375,35253,0,0,66,66,0,1,0,1,0
53773,443,19967,443,499,425,74,4,0,3,1
55563,53,47239,53,194,102,92,2,31,1,1
8999,15503,0,0,146,146,0,1,0,1,0
49189,443,36551,443,15611,1501,14110,32,361,14,18
55991,53,53761,53,182,93,89,2,30,1,1
51916,24596,60319,24596,70,70,0,1,5,1,0
39244,36829,0,0,62,62,0,1,0,1,0
57302,62413,0,0,66,66,0,1,0,1,0
46056,80,34041,80,5066,4404,662,11,30,6,5
37611,443,31494,443,3936,1618,2318,26,146,14,12
57961,445,0,0,70,70,0,1,0,1,0
60765,445,0,0,66,66,0,1,0,1,0
57604,443,23765,443,2614,1689,925,18,21,10,8
50500,53,25369,53,166,86,80,2,30,1,1
52483,445,0,0,70,70,0,1,0,1,0
55115,53,50368,53,313,110,203,4,35,2,2
36103,443,46915,443,130,70,60,2,15,1,1
15499,22114,0,0,62,62,0,1,0,1,0
57288,53,40505,53,177,94,83,2,30,1,1
65174,53,57194,53,214,110,104,2,30,1,1
61891,445,0,0,70,70,0,1,0,1,0
1026,30188,0,0,62,62,0,1,0,1,0
7619,50584,0,0,62,62,0,1,0,1,0
64755,445,0,0,70,70,0,1,0,1,0
65125,445,0,0,70,70,0,1,0,1,0
64993,53,50463,53,748,95,653,2,30,1,1
65376,445,0,0,66,66,0,1,0,1,0
21108,25174,0,0,62,62,0,1,0,1,0
57654,35440,0,0,66,66,0,1,0,1,0
62919,993,20862,993,134,60,74,3,11,2,1
55854,54369,0,0,74,74,0,1,0,1,0
58638,5900,0,0,62,62,0,1,0,1,0
51674,51505,0,0,66,66,0,1,0,1,0
57862,445,0,0,66,66,0,1,0,1,0
48984,15000,36697,15000,130,70,60,2,5,1,1
27005,27015,32214,27015,878,126,752,2,30,1,1
41098,80,34310,80,1937,1193,744,12,16,7,5
59222,53,30617,53,181,86,95,2,30,1,1
53790,53,7041,53,167,78,89,2,29,1,1
64358,445,0,0,70,70,0,1,0,1,0
55004,443,44724,443,7960,2219,5741,27,35,16,11
36368,80,58408,80,78,78,0,1,5,1,0
61720,445,0,0,66,66,0,1,0,1,0
54631,44847,0,0,70,70,0,1,0,1,0
443,44138,0,0,60,60,0,1,0,1,0
65154,53,12899,53,196,94,102,2,30,1,1
55776,53,52683,53,216,110,106,2,30,1,1
50704,80,8069,80,499,192,307,6,26,4,2
59755,44512,0,0,66,66,0,1,0,1,0
50339,80,14820,80,306,180,126,6,41,4,2
34152,11119,0,0,148,148,0,1,0,1,0
27641,39004,0,0,62,62,0,1,0,1,0
49965,53,10762,53,226,110,116,2,30,1,1
52107,11191,10065,11191,70,70,0,1,4,1,0
52710,445,0,0,66,66,0,1,0,1,0
49882,443,5946,443,5019,1424,3595,15,87,9,6
49631,53,32416,53,323,102,221,2,30,1,1
57153,445,0,0,66,66,0,1,0,1,0
62053,443,33820,443,134,60,74,3,5,2,1
50659,443,57690,443,7128,2589,4539,25,37,15,10
51066,445,0,0,66,66,0,1,0,1,0
54906,445,0,0,66,66,0,1,0,1,0
35267,80,35004,80,613,539,74,7,15,6,1
52898,445,0,0,70,70,0,1,0,1,0
52136,443,52136,443,298081,63335,234746,337,323,145,192
60188,15503,0,0,66,66,0,1,0,1,0
58784,443,58898,443,41305,2456,38849,63,30,29,34
13727,13751,0,0,148,148,0,1,0,1,0
63590,443,25710,443,6187,933,5254,18,147,10,8
50470,61463,0,0,86,86,0,1,0,1,0
38807,443,38807,443,5741,2532,3209,24,80,14,10
3352,50584,0,0,66,66,0,1,0,1,0
57871,445,0,0,70,70,0,1,0,1,0
39824,51505,0,0,62,62,0,1,0,1,0
56994,445,0,0,66,66,0,1,0,1,0
52220,22,52220,22,8248,3445,4803,57,38,26,31
52486,445,0,0,66,66,0,1,0,1,0
51977,443,5724,443,2497,1528,969,22,46,13,9
40512,57470,0,0,74,74,0,1,0,1,0
61916,64097,0,0,66,66,0,1,0,1,0
56704,53,43778,53,194,102,92,2,29,1,1
54493,445,0,0,70,70,0,1,0,1,0
47821,53,47821,53,228,97,131,2,30,1,1
59879,443,12932,443,302,120,182,6,32,3,3
19204,56448,0,0,78,78,0,1,0,1,0
49521,53,3193,53,183,94,89,2,30,1,1
45941,23386,0,0,60,60,0,1,0,1,0
61544,445,0,0,66,66,0,1,0,1,0
6666,21,6666,21,66,66,0,1,5,1,0
50788,48817,0,0,62,62,0,1,0,1,0
27005,27216,33781,27216,872,126,746,2,30,1,1
57772,445,0,0,70,70,0,1,0,1,0
46893,443,27910,443,622,70,552,10,180,2,8
44538,50584,0,0,146,146,0,1,0,1,0
1638,22114,0,0,62,62,0,1,0,1,0
64289,53,64357,53,199,102,97,2,30,1,1
53896,48027,30657,48027,70,70,0,1,5,1,0
56833,445,0,0,70,70,0,1,0,1,0
53016,443,45563,443,50403,2032,48371,66,108,21,45
65129,53,27603,53,213,102,111,2,30,1,1
16387,64075,0,0,60,60,0,1,0,1,0
52690,445,0,0,70,70,0,1,0,1,0
31130,30188,0,0,62,62,0,1,0,1,0
53089,24211,0,0,66,66,0,1,0,1,0
51922,18413,51851,18413,70,70,0,1,5,1,0
53165,445,0,0,70,70,0,1,0,1,0
0,0,0,0,98,98,0,1,0,1,0
52294,445,0,0,66,66,0,1,0,1,0
54716,443,54716,443,4728,1821,2907,19,29,11,8
55605,27274,9607,27274,130,70,60,2,4,1,1
55645,443,7018,443,9213,3751,5462,17,121,8,9
34129,19410,0,0,60,60,0,1,0,1,0
19875,30170,0,0,145,145,0,1,0,1,0
43916,21,0,0,60,60,0,1,0,1,0
13684,25174,0,0,62,62,0,1,0,1,0
21447,53,34557,53,80280,68084,12196,889,90,816,73
61560,445,0,0,70,70,0,1,0,1,0
51911,14543,20500,14543,70,70,0,1,5,1,0
52169,80,44471,80,362,240,122,7,17,5,2
49454,445,0,0,66,66,0,1,0,1,0
52830,22114,0,0,146,146,0,1,0,1,0
57325,37965,0,0,62,62,0,1,0,1,0
57432,66,6875,66,70,70,0,2,8,2,0
55069,44847,0,0,62,62,0,1,0,1,0
15641,26467,0,0,62,62,0,1,0,1,0
6572,23,0,0,60,60,0,1,0,1,0
56671,443,59090,443,7940,1951,5989,20,16,11,9
49981,44847,0,0,62,62,0,1,0,1,0
7686,25174,0,0,62,62,0,1,0,1,0
53290,443,5427,443,494,288,206,8,26,5,3
27005,27001,28367,27001,883,126,757,2,30,1,1
60806,51050,0,0,62,62,0,1,0,1,0
40811,80,13530,80,31286,2032,29254,50,30,26,24
65372,53,1041,53,196,100,96,2,31,1,1
60774,445,0,0,66,66,0,1,0,1,0
443,43775,0,0,97,97,0,1,0,1,0
51826,58925,47237,58925,70,70,0,1,4,1,0
39915,443,23556,443,27886,17603,10283,138,462,76,62
49418,27015,16562,27015,269,71,198,2,31,1,1
53810,23,0,0,60,60,0,1,0,1,0
50238,445,0,0,70,70,0,1,0,1,0
60571,26467,0,0,62,62,0,1,0,1,0
45964,3111,0,0,60,60,0,1,0,1,0
54583,443,25809,443,11307,7633,3674,25,163,18,7
49359,53,18321,53,216,110,106,2,30,1,1
60829,445,0,0,70,70,0,1,0,1,0
37952,80,16690,80,1372,868,504,13,35,8,5
64789,53,3910,53,198,101,97,2,30,1,1
3730,17372,0,0,62,62,0,1,0,1,0
51636,80,6805,80,318,192,126,6,39,4,2
60166,53,7820,53,258,94,164,2,30,1,1
50662,443,44987,443,3306,1714,1592,17,16,9,8
49481,7000,49481,7000,3066,1675,1391,16,14,9,7
42285,57470,0,0,62,62,0,1,0,1,0
443,45788,0,0,199,199,0,1,0,1,0
57000,80,51268,80,214,140,74,4,35,3,1
48292,80,5673,80,14038,3554,10484,45,1142,16,29
11136,15503,0,0,62,62,0,1,0,1,0
56721,443,14378,443,7889,1900,5989,20,15,11,9
27783,57470,0,0,62,62,0,1,0,1,0
49650,445,0,0,70,70,0,1,0,1,0
49272,53,7753,53,196,100,96,2,30,1,1
52170,443,6811,443,11716,7393,4323,47,146,21,26
54240,443,62221,443,499,425,74,4,0,3,1
65096,37807,0,0,66,66,0,1,0,1,0
16092,50265,0,0,62,62,0,1,0,1,0
57170,53,64269,53,200,102,98,2,31,1,1
64693,445,0,0,70,70,0,1,0,1,0
55620,53,62411,53,178,94,84,2,30,1,1
54538,80,35235,80,4162,3455,707,14,15,8,6
29787,37965,0,0,62,62,0,1,0,1,0
62044,445,0,0,66,66,0,1,0,1,0
35589,25174,0,0,66,66,0,1,0,1,0
60752,28080,10717,28080,70,70,0,1,5,1,0
56324,53,52043,53,177,94,83,2,30,1,1
56174,445,0,0,70,70,0,1,0,1,0
54524,445,0,0,66,66,0,1,0,1,0
7891,25174,0,0,66,66,0,1,0,1,0
56703,53,61350,53,198,101,97,2,31,1,1
55211,445,0,0,70,70,0,1,0,1,0
46625,80,46625,80,51574,3466,48108,63,156,23,40
60786,443,40740,443,12106,2192,9914,38,38,19,19
58638,5900,0,0,62,62,0,1,0,1,0
6882,8999,49067,8999,238,118,120,2,1200,1,1
55140,445,0,0,70,70,0,1,0,1,0
49281,443,26289,443,7655,2377,5278,20,135,11,9
49300,5228,46650,5228,12589,6479,6110,172,4146,86,86
53459,37807,0,0,62,62,0,1,0,1,0
37014,25174,0,0,66,66,0,1,0,1,0
9185,80,20640,80,17855,1067,16788,26,35,11,15
50151,53,17420,53,152,78,74,2,30,1,1
56756,53,22443,53,711,87,624,2,30,1,1
33892,53,0,0,86,86,0,1,30,1,0
65510,53,46580,53,229,102,127,2,30,1,1
53023,443,2353,443,9625,3512,6113,41,92,21,20
53878,55950,30797,55950,70,70,0,1,5,1,0
55704,64097,0,0,66,66,0,1,0,1,0
50116,22,50116,22,152,66,86,2,9,1,1
51020,445,0,0,70,70,0,1,0,1,0
58424,443,8670,443,81295,4140,77155,114,117,42,72
65324,53,23853,53,748,94,654,2,30,1,1
49715,53,2852,53,734,94,640,2,30,1,1
16454,25174,0,0,62,62,0,1,0,1,0
2938,64147,0,0,62,62,0,1,0,1,0
50252,53,45062,53,173,94,79,2,30,1,1
55803,53,42450,53,261,89,172,4,38,2,2
46531,123,21322,123,184,94,90,2,30,1,1
49267,445,0,0,70,70,0,1,0,1,0
1972,57470,0,0,78,78,0,1,0,1,0
55777,53,5442,53,733,94,639,2,29,1,1
63192,445,0,0,70,70,0,1,0,1,0
58638,5900,0,0,62,62,0,1,0,1,0
49301,443,34200,443,7616,3064,4552,14,120,6,8
55057,443,7517,443,1364,940,424,12,16,7,5
52600,22,0,0,60,60,0,1,0,1,0
35905,443,10061,443,8272,2091,6181,25,331,12,13
47910,7454,0,0,60,60,0,1,0,1,0
51923,22114,0,0,146,146,0,1,0,1,0
55703,13836,63794,13836,70,70,0,1,5,1,0
64399,53,19303,53,373,90,283,4,53,2,2
57768,7635,57768,7635,138,78,60,2,6,1,1
56511,53,50821,53,200,102,98,2,30,1,1
50569,80,5164,80,318,192,126,6,26,4,2
47357,50584,0,0,66,66,0,1,0,1,0
47293,443,64269,443,6318,1025,5293,17,31,9,8
57307,443,55707,443,35035,5135,29900,81,216,33,48
38763,30188,0,0,146,146,0,1,0,1,0
55373,1,0,0,66,66,0,1,0,1,0
54390,445,0,0,66,66,0,1,0,1,0
64610,53,2406,53,292,102,190,2,30,1,1
65146,445,0,0,70,70,0,1,0,1,0
56615,53,15642,53,177,94,83,2,29,1,1
25342,8168,0,0,62,62,0,1,0,1,0
50755,80,64278,80,1783,1346,437,7,15,5,2
64087,443,64087,443,150808,48110,102698,173,173,82,91
52943,443,54392,443,14640,5951,8689,52,115,26,26
44063,443,1759,443,7762,2601,5161,18,137,8,10
42971,3478,43871,3478,452,280,172,5,31,3,2
51786,37832,38503,37832,70,70,0,2,8,2,0
29512,30188,0,0,66,66,0,1,0,1,0
43632,80,17222,80,2000,710,1290,8,15,5,3
51221,15886,64989,15886,481,150,331,2,1200,1,1
17004,64147,0,0,66,66,0,1,0,1,0
55808,53,55808,53,257,106,151,2,30,1,1
28668,8696,0,0,60,60,0,1,0,1,0
58134,445,0,0,70,70,0,1,0,1,0
50941,443,22406,443,12831,2277,10554,37,145,17,20
56381,443,16712,443,7236,2290,4946,18,16,11,7
59326,57470,0,0,74,74,0,1,0,1,0
51014,445,0,0,70,70,0,1,0,1,0
61299,25174,0,0,146,146,0,1,0,1,0
36278,7000,36278,7000,3578,1967,1611,16,16,8,8
41674,443,45032,443,14424911,433341,13991570,15454,320,5482,9972
53727,445,0,0,70,70,0,1,0,1,0
53824,41482,6861,41482,70,70,0,1,4,1,0
54634,443,32455,443,225732,7330,218402,246,174,86,160
56293,53,53120,53,164,84,80,2,31,1,1
36464,443,36464,443,4373,1466,2907,19,29,11,8
50787,445,0,0,66,66,0,1,0,1,0
49871,445,0,0,66,66,0,1,0,1,0
55511,443,12800,443,10499,2421,8078,28,15,14,14
13911,57470,0,0,60,60,0,1,0,1,0
49994,80,9515,80,2618,591,2027,11,16,6,5
55673,53,34311,53,179,94,85,2,31,1,1
53841,37965,0,0,66,66,0,1,0,1,0
37680,443,37680,443,4592,1685,2907,19,29,11,8
64684,53,15819,53,184,94,90,2,31,1,1
49761,53,36428,53,373,99,274,4,41,2,2
56695,53,7335,53,183,94,89,2,30,1,1
49377,445,0,0,70,70,0,1,0,1,0
61051,445,0,0,70,70,0,1,0,1,0
49420,53,26234,53,364,102,262,2,30,1,1
53142,47933,51357,47933,698,320,378,10,17,6,4
56440,53,9792,53,711,87,624,2,31,1,1
64463,53,5557,53,182,93,89,2,0,1,1
50241,53,50241,53,260,106,154,2,32,1,1
65101,53,44970,53,749,94,655,2,30,1,1
41677,57470,0,0,62,62,0,1,0,1,0
54408,445,0,0,70,70,0,1,0,1,0
51390,53,51390,53,398,255,143,3,31,2,1
41284,443,45151,443,7252,2147,5105,18,136,8,10
63836,14791,37606,14791,70,70,0,1,4,1,0
58148,43890,0,0,66,66,0,1,0,1,0
65127,53,53558,53,194,102,92,2,29,1,1
63258,445,0,0,66,66,0,1,0,1,0
58875,53,56659,53,370,86,284,2,30,1,1
51812,443,55280,443,10741,7368,3373,32,135,16,16
56118,445,0,0,66,66,0,1,0,1,0
63884,445,0,0,66,66,0,1,0,1,0
60210,80,21481,80,5141,3706,1435,17,151,10,7
30861,46783,0,0,62,62,0,1,0,1,0
49643,443,30041,443,1640,1089,551,14,15,8,6
20508,57470,0,0,62,62,0,1,0,1,0
44649,443,58778,443,7013,1092,5921,21,31,12,9
56496,53,56369,53,193,102,91,2,30,1,1
55632,45682,28003,45682,70,70,0,2,8,2,0
25565,51337,0,0,60,60,0,1,0,1,0
61929,445,0,0,70,70,0,1,0,1,0
41699,443,36765,443,40273,3243,37030,60,77,28,32
53828,2323,0,0,60,60,0,1,0,1,0
44098,1433,0,0,60,60,0,1,0,1,0
57273,53,29269,53,177,94,83,2,30,1,1
64837,53,35241,53,195,102,93,2,31,1,1
50632,445,0,0,70,70,0,1,0,1,0
56952,53,60759,53,193,102,91,2,30,1,1
58034,443,56445,443,4132,2158,1974,35,255,17,18
63966,42532,2551,42532,70,70,0,1,4,1,0
33924,80,28051,80,1139,609,530,10,61,6,4
49446,445,0,0,70,70,0,1,0,1,0
60848,53,46740,53,168,78,90,2,30,1,1
6881,55980,18375,55980,226,118,108,2,1199,1,1
49301,53,20768,53,214,102,112,2,30,1,1
42478,80,42478,80,1913,1464,449,10,19,6,4
53599,445,0,0,70,70,0,1,0,1,0
48038,5222,35034,5222,49279,23110,26169,459,384,239,220
42717,5900,0,0,60,60,0,1,0,1,0
64912,53,33217,53,183,94,89,2,31,1,1
57431,53,3019,53,181,94,87,2,31,1,1
62438,445,0,0,70,70,0,1,0,1,0
64742,53,28467,53,173,94,79,2,29,1,1
62049,445,0,0,66,66,0,1,0,1,0
44417,53,0,0,82,82,0,2,40,2,0
55360,443,39812,443,6379,1762,4617,27,27,14,13
12107,22114,0,0,62,62,0,1,0,1,0
51845,80,51845,80,28037,2069,25968,40,26,16,24
64835,53,33008,53,200,102,98,2,29,1,1
36306,80,36306,80,1917,1468,449,10,20,6,4
53894,445,0,0,70,70,0,1,0,1,0
56395,53,56804,53,199,102,97,2,29,1,1
60988,443,42425,443,8019,3298,4721,30,40,17,13
56677,53,7912,53,200,102,98,2,30,1,1
58453,50584,0,0,66,66,0,1,0,1,0
55529,44847,0,0,66,66,0,1,0,1,0
53240,443,24615,443,46348,20067,26281,75,60,37,38
64215,53,28280,53,196,94,102,2,30,1,1
56963,53,37570,53,199,102,97,2,29,1,1
54680,443,15778,443,1786,172,1614,7,120,3,4
50975,445,0,0,66,66,0,1,0,1,0
17262,25174,0,0,146,146,0,1,0,1,0
27005,27015,5485,27015,889,126,763,2,30,1,1
36714,80,19257,80,1792,703,1089,12,16,7,5
49724,53,30037,53,470,131,339,4,32,2,2
55066,53,27707,53,180,94,86,2,30,1,1
54054,445,0,0,70,70,0,1,0,1,0
51866,23431,38401,23431,70,70,0,2,8,2,0
64937,53,3891,53,360,118,242,2,30,1,1
46980,443,8668,443,7633,5620,2013,31,60,19,12
65200,51050,0,0,66,66,0,1,0,1,0
65350,53,48602,53,168,86,82,2,31,1,1
49920,443,45165,443,8888,2265,6623,18,15,9,9
64697,37965,0,0,66,66,0,1,0,1,0
52430,35440,0,0,62,62,0,1,0,1,0
51855,443,29819,443,11894,2661,9233,32,32,18,14
56625,53,48390,53,193,102,91,2,29,1,1
49650,53,49396,53,776,102,674,2,31,1,1
56298,53,17699,53,173,94,79,2,30,1,1
57543,445,0,0,70,70,0,1,0,1,0
55006,53,7313,53,711,87,624,2,30,1,1
15113,25174,0,0,146,146,0,1,0,1,0
38688,443,23677,443,90166,3481,86685,96,16,31,65
51748,15177,40687,15177,70,70,0,2,9,2,0
38329,80,52994,80,350,210,140,6,16,4,2
38687,443,37401,443,13923,1728,12195,24,16,10,14
60681,445,0,0,70,70,0,1,0,1,0
65009,53,23695,53,152,78,74,2,30,1,1
50039,7000,50039,7000,3050,1659,1391,16,15,9,7
57138,443,50278,443,498,210,288,8,26,4,4
3410,17372,0,0,62,62,0,1,0,1,0
50036,445,0,0,66,66,0,1,0,1,0
65211,53,49175,53,216,102,114,2,30,1,1
52717,53,4391,53,277,94,183,2,30,1,1
54550,443,8260,443,3296,1329,1967,14,135,7,7
56808,443,31717,443,7981,1961,6020,20,15,11,9
58424,52700,0,0,66,66,0,1,0,1,0
45363,23,0,0,60,60,0,1,0,1,0
65509,53,55791,53,321,102,219,2,30,1,1
55624,53,62232,53,244,94,150,2,29,1,1
52019,80,54297,80,426,240,186,8,24,5,3
443,48346,0,0,81,81,0,1,0,1,0
53766,3596,6099,3596,70,70,0,1,4,1,0
57966,445,0,0,70,70,0,1,0,1,0
55545,53,1793,53,821,102,719,2,30,1,1
50258,443,57201,443,7975,1974,6001,31,210,15,16
65482,53,50244,53,179,94,85,2,30,1,1
49172,445,0,0,70,70,0,1,0,1,0
58115,53,48692,53,578,286,292,9,15,5,4
56730,53,39267,53,177,94,83,2,29,1,1
53419,28189,0,0,60,60,0,1,0,1,0
64164,445,0,0,70,70,0,1,0,1,0
53659,445,0,0,70,70,0,1,0,1,0
61420,443,13668,443,6327,1143,5184,18,28,9,9
56952,53,29584,53,193,102,91,2,30,1,1
65419,26467,0,0,62,62,0,1,0,1,0
57285,445,0,0,66,66,0,1,0,1,0
52054,80,38291,80,41406,4176,37230,57,32,25,32
62267,445,0,0,70,70,0,1,0,1,0
43260,41615,0,0,145,145,0,1,0,1,0
54660,445,0,0,70,70,0,1,0,1,0
58660,445,0,0,70,70,0,1,0,1,0
49539,53,44717,53,170,87,83,2,31,1,1
60245,445,0,0,66,66,0,1,0,1,0
52807,445,0,0,66,66,0,1,0,1,0
10808,443,10808,443,4902,861,4041,15,16,7,8
50265,23,0,0,60,60,0,1,0,1,0
64877,53,56552,53,183,94,89,2,29,1,1
6881,6881,38378,6881,231,111,120,2,1200,1,1
63658,445,0,0,66,66,0,1,0,1,0
31978,57470,0,0,60,60,0,1,0,1,0
32675,53,58212,53,218,78,140,2,30,1,1
61546,443,4493,443,208,60,148,4,13,2,2
5223,32965,0,0,66,66,0,1,0,1,0
61489,443,63810,443,4624,1191,3433,23,75,14,9
1143,25174,0,0,62,62,0,1,0,1,0
56138,53,23162,53,177,94,83,2,30,1,1
53869,17089,38908,17089,70,70,0,1,4,1,0
55606,445,0,0,70,70,0,1,0,1,0
57749,15000,61462,15000,130,70,60,2,6,1,1
17018,53,17018,53,217,87,130,2,30,1,1
43288,443,20649,443,11123,2634,8489,22,121,10,12
65289,53,55084,53,174,89,85,2,31,1,1
56281,445,0,0,66,66,0,1,0,1,0
18592,44612,0,0,62,62,0,1,0,1,0
53855,445,0,0,70,70,0,1,0,1,0
4019,50584,0,0,66,66,0,1,0,1,0
58638,5900,0,0,62,62,0,1,0,1,0
56226,53,55576,53,512,187,325,6,58,3,3
20012,311,0,0,60,60,0,1,0,1,0
3559,30188,0,0,62,62,0,1,0,1,0
61591,22114,0,0,146,146,0,1,0,1,0
58025,80,19163,80,708,384,324,12,23,7,5
50913,80,46319,80,12767608,157856,12609752,11936,135,2227,9709
55194,53,53010,53,190,97,93,2,31,1,1
49627,53,55437,53,760,97,663,2,30,1,1
25857,57354,0,0,145,145,0,1,0,1,0
56578,64147,0,0,62,62,0,1,0,1,0
65189,27214,42310,27214,231,78,153,2,29,1,1
51109,11392,0,0,62,62,0,1,0,1,0
443,46382,0,0,66,66,0,1,0,1,0
57250,445,0,0,66,66,0,1,0,1,0
52472,7302,0,0,62,62,0,1,0,1,0
38278,443,39999,443,448,78,370,6,25,1,5
43893,443,47910,443,1440,719,721,15,198,8,7
55877,62071,53667,62071,481,150,331,2,1200,1,1
55029,443,11495,443,7682,3198,4484,27,17,16,11
55544,3389,55544,3389,3657,1638,2019,20,18,11,9
57364,53,57364,53,213,79,134,2,32,1,1
47034,443,4001,443,4531,3268,1263,23,27,13,10
60290,53,35403,53,213,86,127,2,30,1,1
57584,443,53316,443,915797,52405,863392,1231,269,604,627
53543,44847,0,0,62,62,0,1,0,1,0
50082,445,0,0,66,66,0,1,0,1,0
56267,445,0,0,70,70,0,1,0,1,0
58091,51505,0,0,62,62,0,1,0,1,0
6666,50070,0,0,60,60,0,1,0,1,0
64585,53,40349,53,210,110,100,2,30,1,1
65418,443,32664,443,2494,1643,851,17,26,9,8
27005,32063,51455,32063,889,126,763,3,31,2,1
65274,53,19286,53,295,101,194,4,32,2,2
43111,8080,0,0,60,60,0,1,0,1,0
53638,445,0,0,70,70,0,1,0,1,0
39029,53,55192,53,198,93,105,2,31,1,1
63331,51221,0,0,62,62,0,1,0,1,0
27898,52700,0,0,62,62,0,1,0,1,0
49637,443,18252,443,50296,4666,45630,90,31,43,47
62765,16933,0,0,66,66,0,1,0,1,0
64244,53,1570,53,199,102,97,2,31,1,1
60383,16881,9133,16881,564,318,246,9,18,5,4
48737,443,47925,443,5220,2290,2930,15,121,7,8
65340,53,24167,53,313,110,203,4,34,2,2
63984,53,63454,53,264,110,154,2,30,1,1
49767,445,0,0,66,66,0,1,0,1,0
19270,56448,0,0,78,78,0,1,0,1,0
36770,56205,0,0,62,62,0,1,0,1,0
61675,443,61675,443,8512,2483,6029,21,18,12,9
56662,80,65360,80,234,234,0,4,12,4,0
51000,445,0,0,70,70,0,1,0,1,0
55701,31543,58312,31543,320,140,180,6,5,3,3
56144,53,34369,53,177,94,83,2,30,1,1
60382,445,0,0,70,70,0,1,0,1,0
56670,445,0,0,66,66,0,1,0,1,0
52912,53,52912,53,237,91,146,2,32,1,1
2919,57866,0,0,66,66,0,1,0,1,0
5575,8889,5575,8889,497,497,0,1,0,1,0
46275,64147,0,0,62,62,0,1,0,1,0
44799,443,2515,443,3467,2186,1281,16,15,9,7
53563,445,0,0,70,70,0,1,0,1,0
55340,53,11264,53,184,94,90,2,30,1,1
37420,44847,0,0,66,66,0,1,0,1,0
55855,53,25503,53,182,102,80,2,30,1,1
62767,57470,0,0,74,74,0,1,0,1,0
49481,53,49481,53,222,101,121,2,31,1,1
65317,51221,0,0,78,78,0,1,0,1,0
49713,53,16907,53,184,94,90,2,30,1,1
55531,53,57594,53,370,126,244,2,30,1,1
55470,445,0,0,66,66,0,1,0,1,0
56004,53,58058,53,178,94,84,2,30,1,1
55843,53,38678,53,177,94,83,2,30,1,1
53470,53,29709,53,168,78,90,2,30,1,1
58486,57470,0,0,66,66,0,1,0,1,0
50682,80,52857,80,5237,680,4557,12,170,6,6
52274,80,52274,80,852970,14195,838775,769,28,207,562
62876,445,0,0,66,66,0,1,0,1,0
51487,445,0,0,70,70,0,1,0,1,0
53227,64097,0,0,66,66,0,1,0,1,0
56406,445,0,0,70,70,0,1,0,1,0
51615,25174,0,0,66,66,0,1,0,1,0
35461,5228,26150,5228,8648,2111,6537,40,7038,21,19
3074,64147,0,0,62,62,0,1,0,1,0
58736,445,0,0,70,70,0,1,0,1,0
46495,4607,0,0,60,60,0,1,0,1,0
56073,445,0,0,70,70,0,1,0,1,0
56246,80,56246,80,101654,1739,99915,95,15,25,70
58993,445,0,0,70,70,0,1,0,1,0
52319,443,62232,443,569666,25343,544323,721,46,320,401
55182,53,55293,53,199,102,97,2,30,1,1
993,4281,0,0,66,66,0,1,0,1,0
55505,53,4978,53,199,102,97,2,29,1,1
57470,6882,62846,6882,528,528,0,9,1200,9,0
64009,53,32252,53,209,110,99,2,30,1,1
45941,23384,0,0,60,60,0,1,0,1,0
59574,443,1442,443,2582500,86854,2495646,2678,84,986,1692
39452,123,25633,123,184,94,90,2,30,1,1
48589,443,15567,443,15400,9133,6267,40,272,22,18
43603,443,42478,443,8420,2986,5434,23,138,13,10
63934,53,27798,53,347,103,244,4,46,2,2
65159,37965,0,0,74,74,0,1,0,1,0
59799,443,7688,443,10642,1102,9540,25,27,11,14
46865,80,11797,80,662,600,62,12,495,11,1
31021,35440,0,0,62,62,0,1,0,1,0
49652,445,0,0,70,70,0,1,0,1,0
51622,445,0,0,70,70,0,1,0,1,0
50306,443,54494,443,9889,2800,7089,28,82,17,11
55935,445,0,0,70,70,0,1,0,1,0
53190,80,50867,80,1873,713,1160,10,15,5,5
55610,23383,23402,23383,70,70,0,2,8,2,0
53825,58968,36842,58968,70,70,0,1,4,1,0
37485,161,0,0,6435,2535,3900,22,30,11,11
65012,32468,0,0,66,66,0,1,0,1,0
54476,443,29193,443,48303,3997,44306,69,271,30,39
16693,53,16693,53,217,87,130,2,31,1,1
36902,443,18209,443,10252,2152,8100,38,126,18,20
8389,80,8389,80,1700,1073,627,15,84,8,7
4651,443,4651,443,14579,1280,13299,25,16,9,16
50282,443,7706,443,24856,2858,21998,57,100,30,27
50610,445,0,0,70,70,0,1,0,1,0
65135,53,23354,53,312,102,210,2,30,1,1
64394,443,20424,443,3182,1568,1614,8,120,4,4
39434,5228,17809,5228,3505,2006,1499,30,3744,15,15
47894,443,64449,443,70,70,0,2,5,2,0
59018,445,0,0,66,66,0,1,0,1,0
52100,54130,1109,54130,70,70,0,1,4,1,0
49662,443,39223,443,2690,1342,1348,23,19,12,11
1972,57470,0,0,78,78,0,1,0,1,0
49525,445,0,0,70,70,0,1,0,1,0
51242,445,0,0,70,70,0,1,0,1,0
37346,443,8413,443,7814,2339,5475,26,316,12,14
18754,30188,0,0,66,66,0,1,0,1,0
16687,10214,0,0,66,66,0,1,0,1,0
6881,6881,22683,6881,502,150,352,2,1200,1,1
11136,19910,0,0,62,62,0,1,0,1,0
52564,445,0,0,70,70,0,1,0,1,0
53160,39001,43902,39001,70,70,0,1,5,1,0
46275,64147,0,0,62,62,0,1,0,1,0
38383,51221,0,0,66,66,0,1,0,1,0
50807,445,0,0,70,70,0,1,0,1,0
52931,443,65247,443,8519,1687,6832,29,17,16,13
2582,80,2582,80,8395,700,7695,17,15,8,9
12143,56205,0,0,66,66,0,1,0,1,0
38677,443,24014,443,89883,3417,86466,94,15,30,64
55468,53,52823,53,754,94,660,2,31,1,1
14459,11848,0,0,148,148,0,1,0,1,0
57094,53,64941,53,192,98,94,2,31,1,1
48269,443,55381,443,4800,3396,1404,19,60,10,9
33627,36237,0,0,66,66,0,1,0,1,0
9326,443,61009,443,3616,429,3187,11,15,6,5
48681,80,45826,80,918,461,457,9,15,6,3
57109,53,6255,53,168,86,82,2,30,1,1
58638,5900,0,0,62,62,0,1,0,1,0
36154,47807,0,0,146,146,0,1,0,1,0
51107,80,41417,80,8827,4961,3866,34,47,18,16
56682,443,39754,443,8735,1819,6916,23,22,14,9
53866,445,0,0,70,70,0,1,0,1,0
58419,445,0,0,70,70,0,1,0,1,0
61018,443,61018,443,4400,1493,2907,19,29,11,8
50140,44847,0,0,62,62,0,1,0,1,0
49858,443,16431,443,2027955,75406,1952549,2104,60,564,1540
57288,53,13037,53,177,94,83,2,30,1,1
49357,53,3200,53,211,102,109,2,30,1,1
26698,25174,0,0,66,66,0,1,0,1,0
40977,21247,0,0,66,66,0,1,0,1,0
49304,443,52179,443,932965,16289,916676,768,65,148,620
39100,2767,0,0,62,62,0,1,0,1,0
60923,445,0,0,70,70,0,1,0,1,0
64756,11392,0,0,62,62,0,1,0,1,0
58638,5900,0,0,62,62,0,1,0,1,0
42298,4126,11425,4126,132,64,68,2,30,1,1
55183,445,0,0,70,70,0,1,0,1,0
56281,53,56281,53,851,114,737,2,30,1,1
11005,30188,0,0,146,146,0,1,0,1,0
63826,445,0,0,66,66,0,1,0,1,0
53250,443,53250,443,1464,757,707,18,121,9,9
62045,445,0,0,70,70,0,1,0,1,0
65229,53,47918,53,195,102,93,2,30,1,1
44889,443,7395,443,9982,2062,7920,37,120,19,18
34166,22114,0,0,62,62,0,1,0,1,0
1024,50265,0,0,62,62,0,1,0,1,0
22587,30188,0,0,66,66,0,1,0,1,0
53532,22114,0,0,62,62,0,1,0,1,0
51821,443,38521,443,3002,258,2744,9,119,4,5
63799,13835,2064,13835,66,66,0,2,8,2,0
65090,53,43740,53,209,102,107,2,30,1,1
52426,443,20298,443,8760,1218,7542,25,15,14,11
49238,445,0,0,70,70,0,1,0,1,0
33227,443,20860,443,8888,1757,7131,26,174,15,11
42382,443,39819,443,4844,1099,3745,18,25,10,8
12465,11392,0,0,62,62,0,1,0,1,0
57262,53,45135,53,94,94,0,1,30,1,0
46103,80,5613,80,70,70,0,2,5,2,0
52036,52608,31210,52608,70,70,0,1,4,1,0
33401,51505,0,0,66,66,0,1,0,1,0
49566,53,59606,53,200,94,106,2,30,1,1
35828,8970,0,0,146,146,0,1,0,1,0
64318,53,59823,53,182,93,89,2,31,1,1
55960,445,0,0,70,70,0,1,0,1,0
58638,5900,0,0,62,62,0,1,0,1,0
57824,443,57824,443,4669,1762,2907,19,30,11,8
64097,443,12441,443,6372,1893,4479,15,120,8,7
16387,20045,0,0,60,60,0,1,0,1,0
55662,53,45972,53,212,102,110,2,30,1,1
55106,443,7279,443,3411,887,2524,12,120,6,6
52949,445,0,0,70,70,0,1,0,1,0
50402,445,0,0,66,66,0,1,0,1,0
56769,443,25443,443,7941,1952,5989,20,15,11,9
55826,53,27290,53,86,86,0,2,34,2,0
54895,445,0,0,70,70,0,1,0,1,0
65357,53,15221,53,176,90,86,2,30,1,1
64180,445,0,0,70,70,0,1,0,1,0
56750,53,56750,53,217,87,130,2,30,1,1
57309,53,6657,53,197,102,95,2,29,1,1
53481,443,12218,443,5913,4482,1431,30,30,20,10
56166,53,15904,53,186,95,91,2,30,1,1
49760,53,45249,53,183,94,89,2,29,1,1
64062,445,0,0,66,66,0,1,0,1,0
49415,53,62672,53,194,102,92,2,30,1,1
0,0,0,0,400,204,196,4,0,2,2
34932,38608,0,0,62,62,0,1,0,1,0
51490,17500,0,0,100,100,0,1,0,1,0
63050,53,33894,53,384,166,218,2,30,1,1
49372,53,17589,53,216,110,106,2,31,1,1
12965,37965,0,0,66,66,0,1,0,1,0
27005,27024,9068,27024,1760,252,1508,5,31,3,2
52406,445,0,0,70,70,0,1,0,1,0
57115,53,44854,53,728,102,626,2,30,1,1
10151,11809,51182,11809,481,150,331,2,1200,1,1
1024,25174,0,0,62,62,0,1,0,1,0
35440,443,40080,443,7419,2136,5283,23,255,11,12
56513,53,43170,53,184,86,98,2,30,1,1
60129,80,34372,80,2910,1439,1471,12,31,7,5
4862,37965,0,0,66,66,0,1,0,1,0
50418,443,31085,443,4507,744,3763,17,29,7,10
39795,5900,0,0,60,60,0,1,0,1,0
56204,53,48985,53,168,86,82,2,30,1,1
42810,443,64537,443,9265,2134,7131,24,123,12,12
58960,445,0,0,70,70,0,1,0,1,0
64537,443,9854,443,3182,1568,1614,8,120,4,4
51904,51883,50262,51883,70,70,0,1,5,1,0
53102,443,27329,443,983,496,487,9,16,5,4
59937,37965,0,0,66,66,0,1,0,1,0
56664,80,24275,80,1056,682,374,10,15,6,4
51931,445,0,0,70,70,0,1,0,1,0
61747,445,0,0,66,66,0,1,0,1,0
58638,5900,0,0,62,62,0,1,0,1,0
53810,443,43179,443,499,425,74,4,0,3,1
58058,443,59293,443,560,280,280,9,28,5,4
59208,445,0,0,70,70,0,1,0,1,0
65026,53,20362,53,188,96,92,2,30,1,1
56489,53,35362,53,178,94,84,2,29,1,1
60873,443,46332,443,4265,1678,2587,21,142,10,11
1030,35776,0,0,139,139,0,1,0,1,0
39582,80,57536,80,1614,1300,314,10,15,5,5
7881,48817,0,0,133,133,0,1,0,1,0
64452,445,0,0,70,70,0,1,0,1,0
61243,445,0,0,70,70,0,1,0,1,0
49459,53,5838,53,199,102,97,2,29,1,1
63877,445,0,0,70,70,0,1,0,1,0
13285,29892,0,0,145,145,0,1,0,1,0
61522,445,0,0,70,70,0,1,0,1,0
49991,53,8139,53,198,102,96,2,30,1,1
64376,53,21911,53,210,94,116,2,30,1,1
55423,53,61643,53,711,87,624,2,31,1,1
56979,53,50230,53,209,110,99,2,30,1,1
53864,443,31491,443,3124,1556,1568,21,275,11,10
34360,25174,0,0,62,62,0,1,0,1,0
54914,51505,0,0,62,62,0,1,0,1,0
49170,443,23155,443,7743,1601,6142,18,16,10,8
51829,80,1041,80,1484,928,556,13,76,8,5
57368,7302,0,0,66,66,0,1,0,1,0
56782,49135,47020,49135,70,70,0,2,8,2,0
65036,53,38858,53,214,110,104,2,29,1,1
50265,60276,27315,60276,481,150,331,2,1200,1,1
0,0,0,0,98,98,0,1,0,1,0
30629,46783,0,0,145,145,0,1,0,1,0
52088,35605,27322,35605,70,70,0,1,5,1,0
38785,443,33251,443,5206,3832,1374,23,25,13,10
54252,445,0,0,70,70,0,1,0,1,0
57131,26296,0,0,145,145,0,1,0,1,0
51254,445,0,0,66,66,0,1,0,1,0
55603,32520,10079,32520,5982,1890,4092,30,75,15,15
56862,80,27370,80,2058,589,1469,10,45,6,4
61600,56205,0,0,66,66,0,1,0,1,0
62738,443,30177,443,126,60,66,3,10,2,1
49163,22114,0,0,62,62,0,1,0,1,0
65120,445,0,0,66,66,0,1,0,1,0
60838,445,0,0,70,70,0,1,0,1,0
62923,445,0,0,70,70,0,1,0,1,0
50533,445,0,0,66,66,0,1,0,1,0
10797,50584,0,0,62,62,0,1,0,1,0
58638,5900,58638,5900,66,66,0,1,4,1,0
43480,443,57887,443,58423,25600,32823,86,138,40,46
55415,445,0,0,70,70,0,1,0,1,0
50594,80,17201,80,3116,452,2664,18,394,5,13
7521,20234,0,0,157,157,0,1,0,1,0
5588,5588,0,0,3562,1936,1626,48,193,24,24
60896,53,29321,53,168,78,90,2,31,1,1
50980,443,34954,443,7959,3288,4671,19,97,11,8
49516,35894,0,0,62,62,0,1,0,1,0
50804,443,11310,443,6337,1378,4959,19,140,9,10
65099,53,22746,53,199,102,97,2,31,1,1
50466,445,0,0,70,70,0,1,0,1,0
55187,445,0,0,70,70,0,1,0,1,0
59723,443,10674,443,70,70,0,2,5,2,0
57925,443,19196,443,43126,33414,9712,214,220,108,106
63840,36829,0,0,66,66,0,1,0,1,0
23758,44847,0,0,62,62,0,1,0,1,0
56762,25080,40998,25080,70,70,0,1,5,1,0
63116,22114,0,0,62,62,0,1,0,1,0
54618,445,0,0,70,70,0,1,0,1,0
53614,443,48622,443,6352,1552,4800,23,17,12,11
44516,443,57254,443,4709,2451,2258,18,304,8,10
39166,53,0,0,82,82,0,1,31,1,0
53105,42707,0,0,66,66,0,1,0,1,0
52344,445,0,0,66,66,0,1,0,1,0
65004,53,7635,53,261,102,159,2,30,1,1
61542,443,4330,443,6049,1986,4063,23,19,12,11
53663,80,16666,80,149148,7515,141633,197,20,95,102
52415,445,0,0,66,66,0,1,0,1,0
62387,445,0,0,70,70,0,1,0,1,0
60794,20010,2485,20010,70,70,0,1,5,1,0
50766,445,0,0,70,70,0,1,0,1,0
56571,53,42202,53,325,102,223,2,30,1,1
54234,80,54234,80,2334,1575,759,11,148,6,5
51137,80,51137,80,66992,5462,61530,79,26,30,49
51437,80,35977,80,1703,538,1165,8,177,5,3
43309,443,32781,443,60,60,0,1,5,1,0
35501,53,35501,53,213,79,134,2,33,1,1
2075,19473,0,0,66,66,0,1,0,1,0
27528,35440,0,0,62,62,0,1,0,1,0
57122,53,32018,53,216,110,106,2,30,1,1
50010,445,0,0,70,70,0,1,0,1,0
39038,443,14810,443,3970,2230,1740,17,114,10,7
56198,53,15932,53,789,110,679,2,31,1,1
57442,66,49848,66,70,70,0,2,8,2,0
53469,44847,0,0,66,66,0,1,0,1,0
1523,22,0,0,60,60,0,1,0,1,0
53456,445,0,0,70,70,0,1,0,1,0
56227,53,39156,53,194,102,92,2,30,1,1
52167,61948,12539,61948,70,70,0,2,8,2,0
65168,53,15649,53,230,110,120,2,30,1,1
51236,445,0,0,66,66,0,1,0,1,0
59538,80,28530,80,1895,755,1140,11,14,6,5
50282,445,0,0,66,66,0,1,0,1,0
55036,53,3360,53,177,94,83,2,30,1,1
55362,53,13886,53,190,97,93,2,31,1,1
61912,17546,0,0,66,66,0,1,0,1,0
45551,443,60203,443,6964,2091,4873,20,15,10,10
64439,53,21739,53,198,101,97,2,30,1,1
17750,51965,19962,51965,150,150,0,1,1200,1,0
6712,161,0,0,82,82,0,1,0,1,0
47642,443,46910,443,12735,10573,2162,33,316,16,17
55019,443,26461,443,6866,1983,4883,23,330,11,12
6486,64147,0,0,66,66,0,1,0,1,0
57761,15503,0,0,66,66,0,1,0,1,0
53513,56205,0,0,62,62,0,1,0,1,0
35940,47808,0,0,60,60,0,1,0,1,0
61938,443,24031,443,3663,1097,2566,13,136,6,7
51130,61689,0,0,66,66,0,1,0,1,0
65514,445,0,0,70,70,0,1,0,1,0
26351,22114,0,0,62,62,0,1,0,1,0
48470,80,20195,80,959,544,415,11,315,6,5
59510,445,0,0,70,70,0,1,0,1,0
3478,61463,0,0,1004,1004,0,1,0,1,0
58800,445,0,0,70,70,0,1,0,1,0
56369,53,3400,53,168,86,82,2,30,1,1
37965,15509,12475,15509,481,150,331,2,1199,1,1
43129,20220,0,0,62,62,0,1,0,1,0
36419,50584,0,0,62,62,0,1,0,1,0
61846,445,0,0,70,70,0,1,0,1,0
60823,25174,0,0,62,62,0,1,0,1,0
56648,445,0,0,70,70,0,1,0,1,0
39119,53,39119,53,221,89,132,2,30,1,1
61382,443,28176,443,32082,12801,19281,62,150,25,37
63543,445,0,0,66,66,0,1,0,1,0
56528,64147,0,0,62,62,0,1,0,1,0
57636,80,57636,80,147506,3521,143985,125,32,23,102
18750,57866,0,0,62,62,0,1,0,1,0
17378,44847,0,0,62,62,0,1,0,1,0
3691,80,6351,80,6826,1214,5612,20,105,12,8
59267,445,0,0,70,70,0,1,0,1,0
31126,53,31126,53,240,98,142,2,30,1,1
60188,15503,0,0,62,62,0,1,0,1,0
55921,43890,0,0,62,62,0,1,0,1,0
45424,23,0,0,60,60,0,1,0,1,0
38368,15000,38283,15000,130,70,60,2,5,1,1
52934,35776,0,0,159,159,0,1,0,1,0
58638,5900,0,0,62,62,0,1,0,1,0
49881,80,7229,80,1965,1450,515,7,87,5,2
55156,53,47092,53,256,87,169,4,36,2,2
50422,50584,0,0,66,66,0,1,0,1,0
64530,53,39688,53,261,87,174,4,46,2,2
60710,53,32625,53,211,78,133,2,30,1,1
1943,48817,0,0,62,62,0,1,0,1,0
64535,53,33577,53,734,86,648,2,31,1,1
3478,61463,0,0,400,400,0,1,0,1,0
50281,53,33175,53,195,102,93,2,30,1,1
50379,443,5364,443,6748,1843,4905,21,29,11,10
50572,80,21152,80,132,132,0,2,8,2,0
65487,53,41710,53,210,110,100,2,29,1,1
51204,123,19622,123,184,94,90,2,30,1,1
65103,445,0,0,70,70,0,1,0,1,0
51946,445,0,0,70,70,0,1,0,1,0
49458,53,15275,53,280,94,186,2,30,1,1
63672,22114,0,0,62,62,0,1,0,1,0
2064,22114,0,0,62,62,0,1,0,1,0
43154,53,41451,53,168,78,90,2,30,1,1
64987,445,0,0,70,70,0,1,0,1,0
53751,445,0,0,66,66,0,1,0,1,0
57747,80,27520,80,2754,1602,1152,17,22,9,8
50840,80,15901,80,268155,6485,261670,281,25,97,184
63844,445,0,0,66,66,0,1,0,1,0
61758,445,0,0,70,70,0,1,0,1,0
42558,64147,0,0,62,62,0,1,0,1,0
56813,445,0,0,70,70,0,1,0,1,0
50251,35440,0,0,66,66,0,1,0,1,0
42971,3478,56626,3478,452,280,172,5,30,3,2
55646,53,23408,53,182,93,89,2,31,1,1
64767,51221,0,0,62,62,0,1,0,1,0
60463,445,0,0,66,66,0,1,0,1,0
59728,445,0,0,66,66,0,1,0,1,0
49493,445,0,0,70,70,0,1,0,1,0
40880,443,42551,443,8142,2090,6052,22,360,10,12
55533,53,54545,53,183,94,89,2,29,1,1
64811,53,37013,53,193,102,91,2,29,1,1
64524,53,34078,53,184,94,90,2,31,1,1
59747,443,56102,443,1991,1190,801,21,32,11,10
41653,21247,0,0,62,62,0,1,0,1,0
56519,445,0,0,70,70,0,1,0,1,0
55920,25174,0,0,62,62,0,1,0,1,0
5228,3434,0,0,345,345,0,1,0,1,0
55054,443,7526,443,6903,1481,5422,33,612,12,21
44378,995,0,0,60,60,0,1,0,1,0
27464,53,27464,53,233,90,143,2,32,1,1
63515,445,0,0,70,70,0,1,0,1,0
64567,445,0,0,66,66,0,1,0,1,0
33651,36237,0,0,62,62,0,1,0,1,0
65317,51221,0,0,78,78,0,1,0,1,0
443,48346,0,0,81,81,0,1,0,1,0
54924,443,20791,443,53816,22991,30825,139,306,71,68
64794,80,22092,80,22646,1660,20986,29,135,10,19
51185,37965,0,0,66,66,0,1,0,1,0
54316,53,0,0,325,77,248,2,31,1,1
57083,53,56856,53,755,94,661,2,31,1,1
50094,445,0,0,66,66,0,1,0,1,0
63390,445,0,0,66,66,0,1,0,1,0
57240,445,0,0,70,70,0,1,0,1,0
63583,37965,0,0,66,66,0,1,0,1,0
5180,57866,0,0,66,66,0,1,0,1,0
60884,443,60884,443,4918,1626,3292,17,17,10,7
52887,445,0,0,70,70,0,1,0,1,0
55006,53,44866,53,789,110,679,2,30,1,1
55962,53,7744,53,193,102,91,2,30,1,1
49160,51413,10192,51413,800,150,650,4,1200,2,2
58889,445,0,0,70,70,0,1,0,1,0
64343,53,64343,53,216,98,118,2,30,1,1
60075,443,54321,443,6300,1427,4873,20,141,9,11
51010,445,0,0,70,70,0,1,0,1,0
63043,445,0,0,70,70,0,1,0,1,0
1733,65448,0,0,62,62,0,1,0,1,0
63263,57470,0,0,66,66,0,1,0,1,0
54269,443,49860,443,5768,3426,2342,22,135,11,11
56544,443,50945,443,3413,1537,1876,19,7,10,9
60172,445,0,0,70,70,0,1,0,1,0
60070,44847,0,0,66,66,0,1,0,1,0
55685,48407,34505,48407,320,140,180,6,6,3,3
46099,80,56104,80,70,70,0,2,5,2,0
48817,51413,48817,51413,479,152,327,2,1200,1,1
49950,23,0,0,60,60,0,1,0,1,0
52514,80,2585,80,3224,2776,448,11,15,7,4
60384,443,37407,443,39385,3771,35614,67,129,27,40
56652,53,11062,53,177,94,83,2,30,1,1
25889,11446,0,0,66,66,0,1,0,1,0
58058,445,0,0,70,70,0,1,0,1,0
60893,443,5461,443,46690,9390,37300,77,54,36,41
22285,3389,22285,3389,293,223,70,4,0,3,1
38082,443,40503,443,9037,1851,7186,26,180,14,12
55820,53,22468,53,184,94,90,2,29,1,1
65295,53,10641,53,212,102,110,2,29,1,1
50283,445,0,0,70,70,0,1,0,1,0
49770,80,9129,80,254,128,126,5,15,3,2
56946,53,14578,53,732,89,643,2,31,1,1
59245,445,0,0,70,70,0,1,0,1,0
4110,35440,0,0,66,66,0,1,0,1,0
64804,53,12585,53,383,97,286,4,58,2,2
993,16279,0,0,129,129,0,1,0,1,0
54760,445,0,0,66,66,0,1,0,1,0
64566,445,0,0,70,70,0,1,0,1,0
60688,445,0,0,70,70,0,1,0,1,0
57195,53,47926,53,195,102,93,2,33,1,1
60151,445,0,0,70,70,0,1,0,1,0
44068,443,30325,443,3947,1744,2203,16,361,8,8
40204,40018,64999,40018,150,88,62,2,30,1,1
40127,53,0,0,82,82,0,1,31,1,0
54573,445,0,0,66,66,0,1,0,1,0
50140,445,0,0,70,70,0,1,0,1,0
0,0,0,0,480,244,236,4,0,2,2
57452,57470,0,0,62,62,0,1,0,1,0
34779,443,25876,443,34914,5279,29635,47,543,18,29
64106,64147,0,0,66,66,0,1,0,1,0
61945,445,0,0,70,70,0,1,0,1,0
53692,16624,3177,16624,320,140,180,6,6,3,3
50857,26467,0,0,66,66,0,1,0,1,0
52148,80,27900,80,366,240,126,7,33,5,2
57288,53,40155,53,170,87,83,2,30,1,1
51910,443,32865,443,308,188,120,4,15,2,2
56811,44008,31634,44008,3034,1547,1487,12,16,7,5
51851,48605,8820,48605,136,136,0,3,14,3,0
443,61686,0,0,1484,1484,0,1,0,1,0
55945,53,51093,53,733,86,647,2,30,1,1
41213,25174,0,0,62,62,0,1,0,1,0
51784,34568,52434,34568,66,66,0,1,5,1,0
59285,445,0,0,70,70,0,1,0,1,0
32796,37965,0,0,62,62,0,1,0,1,0
1932,53,37462,53,210,78,132,2,30,1,1
54998,53,27657,53,198,102,96,2,31,1,1
35065,443,35065,443,5537,2290,3247,22,39,13,9
28306,25604,0,0,62,62,0,1,0,1,0
62579,445,0,0,70,70,0,1,0,1,0
51829,445,0,0,66,66,0,1,0,1,0
51167,445,0,0,66,66,0,1,0,1,0
53786,445,0,0,70,70,0,1,0,1,0
64592,53,18733,53,177,94,83,2,30,1,1
28579,64147,0,0,62,62,0,1,0,1,0
63581,445,0,0,70,70,0,1,0,1,0
55657,443,55657,443,30650,11103,19547,66,51,40,26
58845,443,51619,443,22402,14820,7582,52,20,29,23
51806,443,51806,443,1466,856,610,13,27,6,7
53278,445,0,0,66,66,0,1,0,1,0
1035,26467,0,0,62,62,0,1,0,1,0
57987,56125,0,0,90,90,0,1,0,1,0
55948,5223,3545,5223,10038,5272,4766,36,196,20,16
53334,445,0,0,70,70,0,1,0,1,0
57991,22114,0,0,66,66,0,1,0,1,0
57487,443,43988,443,1786,172,1614,7,121,3,4
56958,53,59654,53,816,102,714,2,30,1,1
57013,53,1233,53,178,94,84,2,30,1,1
61386,445,0,0,66,66,0,1,0,1,0
27005,27015,35363,27015,884,126,758,2,31,1,1
58716,9694,0,0,62,62,0,1,0,1,0
59166,445,0,0,70,70,0,1,0,1,0
47337,443,13338,443,14281,2906,11375,15,122,4,11
52026,12523,2339,12523,70,70,0,2,7,2,0
62556,445,0,0,70,70,0,1,0,1,0
38642,443,33643,443,1468,893,575,15,62,8,7
52726,445,0,0,66,66,0,1,0,1,0
51996,35440,0,0,66,66,0,1,0,1,0
49631,445,0,0,70,70,0,1,0,1,0
55286,53,17426,53,268,87,181,4,35,2,2
55638,53,63082,53,168,86,82,2,30,1,1
46176,53,12412,53,168,78,90,2,30,1,1
35005,53,35005,53,233,90,143,2,33,1,1
54883,51505,0,0,62,62,0,1,0,1,0
52077,445,0,0,70,70,0,1,0,1,0
49978,53,47119,53,774,101,673,2,31,1,1
10462,25174,0,0,146,146,0,1,0,1,0
53416,445,0,0,70,70,0,1,0,1,0
63465,56205,0,0,66,66,0,1,0,1,0
54469,80,59842,80,1466,831,635,10,255,6,4
9169,80,55933,80,318,192,126,6,29,4,2
55383,53,49153,53,177,94,83,2,29,1,1
58338,3353,0,0,60,60,0,1,0,1,0
38959,25174,0,0,62,62,0,1,0,1,0
53144,445,0,0,70,70,0,1,0,1,0
59012,443,51105,443,6278,3531,2747,23,122,12,11
62364,445,0,0,66,66,0,1,0,1,0
44633,443,21223,443,5715,1536,4179,24,16,13,11
56035,1310,0,0,66,66,0,1,0,1,0
60420,80,1065,80,14498,6454,8044,24,120,12,12
62297,445,0,0,66,66,0,1,0,1,0
53949,445,0,0,70,70,0,1,0,1,0
52851,445,0,0,70,70,0,1,0,1,0
57647,80,36132,80,1530,1216,314,10,15,5,5
49930,443,7030,443,7934,1836,6098,23,15,13,10
48174,443,2102,443,3889,1992,1897,19,255,10,9
57426,66,14765,66,70,70,0,2,8,2,0
57291,53,9525,53,178,94,84,2,30,1,1
58973,57470,0,0,66,66,0,1,0,1,0
49971,445,0,0,66,66,0,1,0,1,0
62377,443,62377,443,4378,1471,2907,19,27,11,8
55205,53,36429,53,166,85,81,2,31,1,1
64828,53,23782,53,372,94,278,2,30,1,1
4431,32480,0,0,66,66,0,1,0,1,0
2305,35440,0,0,62,62,0,1,0,1,0
51993,443,1370,443,1209,656,553,13,16,8,5
62109,445,0,0,66,66,0,1,0,1,0
56728,443,61064,443,5367,725,4642,15,15,8,7
2946,53,2946,53,240,96,144,2,30,1,1
47812,443,45871,443,25864,15150,10714,105,217,54,51
50084,26672,0,0,62,62,0,1,0,1,0
64088,53,9032,53,434,108,326,4,51,2,2
52110,35411,42303,35411,70,70,0,2,8,2,0
57226,51505,0,0,66,66,0,1,0,1,0
61002,37965,0,0,145,145,0,1,0,1,0
51105,445,0,0,66,66,0,1,0,1,0
1658,443,1658,443,12030,1282,10748,23,17,9,14
52280,445,0,0,66,66,0,1,0,1,0
56700,80,19955,80,51889,4253,47636,68,64,31,37
65354,53,12903,53,168,86,82,2,30,1,1
57059,445,0,0,70,70,0,1,0,1,0
46442,80,6730,80,1373,669,704,10,16,5,5
9121,80,6298,80,318,192,126,6,29,4,2
9251,443,22776,443,6132,767,5365,17,26,9,8
55013,53,33517,53,821,102,719,2,30,1,1
51003,445,0,0,70,70,0,1,0,1,0
43611,61903,0,0,148,148,0,1,0,1,0
58638,5900,0,0,62,62,0,1,0,1,0
56393,443,8306,443,25779,3436,22343,42,109,19,23
37629,443,33990,443,172,172,0,2,5,2,0
57870,445,0,0,66,66,0,1,0,1,0
36663,22114,0,0,62,62,0,1,0,1,0
53835,62413,0,0,62,62,0,1,0,1,0
58638,5900,0,0,62,62,0,1,0,1,0
61366,445,0,0,66,66,0,1,0,1,0
49610,53,51833,53,212,102,110,2,30,1,1
56278,445,0,0,70,70,0,1,0,1,0
64512,53,55792,53,244,118,126,2,30,1,1
60141,30188,0,0,66,66,0,1,0,1,0
32648,55108,0,0,145,145,0,1,0,1,0
49611,80,38044,80,378,192,186,7,41,4,3
54996,53,39612,53,168,86,82,2,35,1,1
56789,443,21644,443,257154,11550,245604,303,54,121,182
10038,443,58313,443,7481,2070,5411,25,315,12,13
58413,445,0,0,70,70,0,1,0,1,0
44846,53,44846,53,653,349,304,5,30,3,2
54965,80,28312,80,3419,2046,1373,12,515,7,5
63944,8999,41992,8999,70,70,0,1,5,1,0
40294,28680,0,0,145,145,0,1,0,1,0
55584,53,28071,53,177,94,83,2,30,1,1
42745,50011,0,0,62,62,0,1,0,1,0
52323,445,0,0,70,70,0,1,0,1,0
58550,21247,0,0,66,66,0,1,0,1,0
38059,443,31779,443,25214,14000,11214,66,99,34,32
64414,53,36942,53,183,94,89,2,29,1,1
42298,40042,61783,40042,273,73,200,4,29,2,2
27005,27015,17073,27015,886,126,760,2,30,1,1
51978,80,13488,80,24474,2101,22373,38,48,19,19
53979,26308,29256,26308,70,70,0,1,4,1,0
61601,445,0,0,70,70,0,1,0,1,0
60580,53,24695,53,229,94,135,2,30,1,1
54769,50584,0,0,62,62,0,1,0,1,0
39927,443,15384,443,7787,2370,5417,23,242,11,12
52887,37807,0,0,66,66,0,1,0,1,0
56326,53,62646,53,177,94,83,2,30,1,1
64780,53,40708,53,193,102,91,2,31,1,1
56951,53,31350,53,199,102,97,2,30,1,1
26229,21247,0,0,66,66,0,1,0,1,0
21750,39004,0,0,66,66,0,1,0,1,0
62388,39004,0,0,62,62,0,1,0,1,0
54521,445,0,0,70,70,0,1,0,1,0
60376,445,0,0,70,70,0,1,0,1,0
56989,53,25786,53,168,94,74,2,30,1,1
65385,53,9523,53,227,110,117,2,30,1,1
9227,443,31374,443,5146,960,4186,17,25,9,8
27005,30006,10243,30006,888,126,762,3,31,2,1
35218,53,23519,53,168,78,90,2,30,1,1
55026,53,51536,53,164,86,78,2,30,1,1
9477,443,41654,443,7461,1448,6013,22,35,11,11
57014,445,0,0,66,66,0,1,0,1,0
58040,445,0,0,66,66,0,1,0,1,0
53006,443,46019,443,17711,5894,11817,47,96,24,23
50616,53,45129,53,177,94,83,2,30,1,1
64192,53,23253,53,308,110,198,2,29,1,1
59570,445,0,0,70,70,0,1,0,1,0
56367,445,0,0,70,70,0,1,0,1,0
64969,445,0,0,70,70,0,1,0,1,0
6247,51221,0,0,78,78,0,1,0,1,0
34936,30188,0,0,62,62,0,1,0,1,0
35702,443,51381,443,13428,5815,7613,42,995,22,20
53805,443,64828,443,499,425,74,4,0,3,1
60754,445,0,0,70,70,0,1,0,1,0
35670,443,58907,443,295458,11828,283630,339,185,137,202
49647,443,38723,443,11011,4522,6489,35,43,17,18
59883,443,34270,443,8031,2957,5074,27,46,16,11
20961,35440,0,0,62,62,0,1,0,1,0
49418,27015,10254,27015,78,78,0,1,30,1,0
53674,445,0,0,70,70,0,1,0,1,0
51401,443,22599,443,202,70,132,3,11,1,2
56745,445,0,0,66,66,0,1,0,1,0
443,32698,0,0,89,89,0,1,0,1,0
41389,443,45580,443,280,140,140,5,131,3,2
57470,12383,34199,12383,5728,4818,910,87,4485,74,13
58865,445,0,0,70,70,0,1,0,1,0
63599,445,0,0,70,70,0,1,0,1,0
57890,445,0,0,66,66,0,1,0,1,0
34351,53,57036,53,202,83,119,2,31,1,1
50271,445,0,0,70,70,0,1,0,1,0
65332,53,55664,53,94,94,0,1,30,1,0
61078,445,0,0,66,66,0,1,0,1,0
52647,445,0,0,70,70,0,1,0,1,0
53972,445,0,0,70,70,0,1,0,1,0
51026,37450,0,0,66,66,0,1,0,1,0
51246,445,0,0,70,70,0,1,0,1,0
55530,53,3862,53,758,93,665,2,31,1,1
6828,64322,0,0,60,60,0,1,0,1,0
57008,443,25539,443,10572,5109,5463,24,122,12,12
50322,445,0,0,70,70,0,1,0,1,0
16168,23,0,0,60,60,0,1,0,1,0
49377,443,6065,443,6350,1550,4800,23,19,12,11
64313,445,0,0,70,70,0,1,0,1,0
57131,443,18384,443,6489,1065,5424,22,255,12,10
61142,445,0,0,66,66,0,1,0,1,0
56854,17067,53674,17067,70,70,0,2,8,2,0
53661,443,31154,443,8267,1779,6488,23,150,13,10
49487,53,10311,53,183,94,89,2,31,1,1
56312,53,44683,53,756,95,661,2,31,1,1
56377,51505,0,0,66,66,0,1,0,1,0
61256,445,0,0,66,66,0,1,0,1,0
55308,443,1473,443,4981,943,4038,20,360,10,10
63906,36909,30978,36909,66,66,0,2,7,2,0
80,7597,0,0,66,66,0,1,0,1,0
38167,443,36158,443,6150,914,5236,18,16,10,8
50581,53,22242,53,177,94,83,2,30,1,1
57225,445,0,0,66,66,0,1,0,1,0
49860,80,9156,80,6892,2154,4738,22,89,12,10
22150,6881,0,0,146,146,0,1,0,1,0
61865,445,0,0,70,70,0,1,0,1,0
59889,30188,0,0,66,66,0,1,0,1,0
6881,37965,0,0,146,146,0,1,0,1,0
49767,443,22404,443,11883,1419,10464,26,127,11,15
43108,443,11094,443,3117,1867,1250,19,16,9,10
49249,445,0,0,70,70,0,1,0,1,0
55251,53,16099,53,212,110,102,2,30,1,1
45908,33330,0,0,60,60,0,1,0,1,0
14309,56205,0,0,62,62,0,1,0,1,0
55067,53,40121,53,178,94,84,2,30,1,1
53156,35993,0,0,66,66,0,1,0,1,0
49894,1433,0,0,60,60,0,1,0,1,0
50818,445,0,0,66,66,0,1,0,1,0
59955,25,59955,25,1656,677,979,21,16,10,11
3478,61463,0,0,921,921,0,1,0,1,0
6881,8229,31730,8229,150,150,0,1,1200,1,0
52014,80,24294,80,30427,2131,28296,66,32,25,41
40971,1433,0,0,60,60,0,1,0,1,0
64752,53,50636,53,195,102,93,2,30,1,1
65061,53,50134,53,297,101,196,4,33,2,2
57275,53,22195,53,199,102,97,2,31,1,1
56567,445,0,0,70,70,0,1,0,1,0
52966,80,53251,80,2974,1352,1622,28,113,15,13
53152,443,33270,443,116790,7062,109728,166,144,85,81
57096,53,50734,53,177,94,83,2,29,1,1
58890,53,58890,53,198,90,108,2,30,1,1
50503,443,63118,443,5987,1085,4902,15,25,8,7
57371,53,32883,53,212,108,104,2,31,1,1
64693,53,28781,53,248,102,146,2,30,1,1
55125,53,32465,53,177,94,83,2,31,1,1
40787,57470,0,0,62,62,0,1,0,1,0
65114,53,42555,53,380,86,294,2,30,1,1
41632,443,56228,443,8507,4462,4045,27,141,14,13
34911,443,4016,443,414843,13933,400910,459,136,160,299
50052,65010,0,0,60,60,0,1,0,1,0
54040,445,0,0,70,70,0,1,0,1,0
35517,443,27389,443,130,70,60,3,5,2,1
49496,53,24067,53,194,102,92,2,30,1,1
63663,445,0,0,70,70,0,1,0,1,0
45060,37965,0,0,62,62,0,1,0,1,0
61416,80,26249,80,2366,764,1602,10,137,5,5
65239,53,58774,53,199,102,97,2,29,1,1
54087,443,2699,443,2637658,83234,2554424,2794,140,929,1865
57714,53,57714,53,233,90,143,2,32,1,1
27153,992,0,0,60,60,0,1,0,1,0
62902,32468,0,0,66,66,0,1,0,1,0
56050,53,45848,53,172,88,84,2,30,1,1
49001,40108,0,0,161,161,0,1,0,1,0
49275,53,59894,53,190,97,93,2,31,1,1
59156,50584,0,0,62,62,0,1,0,1,0
20222,53,8890,53,223,78,145,2,30,1,1
48488,443,26104,443,12993,3240,9753,36,24,18,18
61408,30188,0,0,62,62,0,1,0,1,0
12608,21247,0,0,66,66,0,1,0,1,0
57244,443,45761,443,230914,10401,220513,290,76,121,169
56889,53,24379,53,177,94,83,2,30,1,1
37988,49152,27635,49152,156,156,0,3,7,3,0
57278,443,35481,443,8960,2949,6011,21,122,10,11
47091,15000,23609,15000,138,78,60,2,6,1,1
60792,443,60792,443,16401,8712,7689,53,297,25,28
62443,445,0,0,70,70,0,1,0,1,0
61341,445,0,0,66,66,0,1,0,1,0
50639,443,28987,443,15714,2748,12966,58,21,23,35
58614,53,27966,53,168,78,90,2,30,1,1
57790,443,14547,443,6321,3341,2980,19,135,9,10
64484,53,32900,53,732,239,493,6,51,3,3
60115,445,0,0,70,70,0,1,0,1,0
48817,38081,48817,38081,863,363,500,4,1200,2,2
56962,445,0,0,66,66,0,1,0,1,0
38334,53,4428,53,168,78,90,2,31,1,1
58716,9694,0,0,62,62,0,1,0,1,0
57281,445,0,0,70,70,0,1,0,1,0
53907,445,0,0,66,66,0,1,0,1,0
54183,445,0,0,70,70,0,1,0,1,0
53316,445,0,0,70,70,0,1,0,1,0
62627,7000,62627,7000,2990,1599,1391,15,15,8,7
65264,53,2001,53,738,86,652,2,30,1,1
58638,5900,0,0,62,62,0,1,0,1,0
42119,36237,0,0,66,66,0,1,0,1,0
63314,57470,0,0,66,66,0,1,0,1,0
50637,445,0,0,66,66,0,1,0,1,0
61345,21247,0,0,66,66,0,1,0,1,0
64865,53,49871,53,305,97,208,4,53,2,2
25237,25174,0,0,62,62,0,1,0,1,0
50997,443,46270,443,3772,2099,1673,22,18,11,11
13947,37965,0,0,145,145,0,1,0,1,0
53252,445,0,0,70,70,0,1,0,1,0
60046,443,51072,443,8241,2346,5895,18,136,8,10
55525,53,5634,53,214,110,104,2,30,1,1
21274,30188,0,0,62,62,0,1,0,1,0
64485,53,11274,53,183,94,89,2,30,1,1
65189,28515,39536,28515,266,78,188,2,30,1,1
50218,53,36162,53,165,86,79,2,31,1,1
52857,445,0,0,66,66,0,1,0,1,0
17226,35440,0,0,62,62,0,1,0,1,0
30960,45732,62764,45732,330,330,0,6,3610,6,0
50605,443,19181,443,13409,3033,10376,29,124,15,14
60465,445,0,0,70,70,0,1,0,1,0
52482,445,0,0,70,70,0,1,0,1,0
17052,53,17052,53,235,90,145,2,32,1,1
59699,55783,0,0,62,62,0,1,0,1,0
1143,25198,0,0,148,148,0,1,0,1,0
39959,23117,0,0,62,62,0,1,0,1,0
42344,48637,0,0,60,60,0,1,0,1,0
50358,445,0,0,70,70,0,1,0,1,0
6881,6882,61481,6882,238,118,120,2,1199,1,1
49702,445,0,0,70,70,0,1,0,1,0
39200,443,57759,443,8918,2361,6557,35,255,18,17
59055,445,0,0,70,70,0,1,0,1,0
57035,80,15633,80,953,524,429,11,256,6,5
60244,445,0,0,70,70,0,1,0,1,0
45912,443,22419,443,4306,1107,3199,17,30,9,8
63399,445,0,0,70,70,0,1,0,1,0
59736,51505,0,0,62,62,0,1,0,1,0
43271,50584,0,0,62,62,0,1,0,1,0
56327,53,49632,53,172,88,84,2,31,1,1
56942,443,55057,443,8172,2656,5516,29,330,15,14
58365,5900,0,0,60,60,0,1,0,1,0
9504,25174,0,0,146,146,0,1,0,1,0
52084,30863,64593,30863,70,70,0,2,7,2,0
63615,445,0,0,66,66,0,1,0,1,0
56810,53,54787,53,170,87,83,2,31,1,1
59651,445,0,0,70,70,0,1,0,1,0
64069,53,35417,53,183,86,97,2,29,1,1
16403,16386,51369,16386,122,62,60,2,29,1,1
64171,53,17588,53,179,94,85,2,30,1,1
62424,445,0,0,66,66,0,1,0,1,0
59999,443,56048,443,3047,1277,1770,16,144,8,8
56104,53,63968,53,197,102,95,2,30,1,1
57470,22796,55699,22796,2224,1852,372,33,1565,27,6
56727,445,0,0,70,70,0,1,0,1,0
53141,443,52504,443,37389,3972,33417,69,133,32,37
54655,445,0,0,70,70,0,1,0,1,0
52010,445,0,0,70,70,0,1,0,1,0
51966,443,48480,443,130,70,60,2,15,1,1
58251,36237,0,0,66,66,0,1,0,1,0
55102,53,47869,53,195,102,93,2,30,1,1
39599,443,45420,443,1352,691,661,14,18,8,6
56026,53,4908,53,183,94,89,2,31,1,1
3478,61463,0,0,1305,1305,0,1,0,1,0
42298,40019,18664,40019,597,79,518,2,31,1,1
52575,445,0,0,70,70,0,1,0,1,0
52650,44847,0,0,66,66,0,1,0,1,0
50202,443,56858,443,8415,3119,5296,26,73,9,17
37900,53,2466,53,78,78,0,1,30,1,0
62115,57470,0,0,66,66,0,1,0,1,0
52120,80,3357,80,366,240,126,7,26,5,2
51678,445,0,0,70,70,0,1,0,1,0
57341,53,32411,53,184,94,90,2,31,1,1
56862,445,0,0,66,66,0,1,0,1,0
54542,443,54542,443,150554,18764,131790,192,117,95,97
53226,443,20634,443,5993,974,5019,19,59,10,9
48388,44847,0,0,146,146,0,1,0,1,0
62639,445,0,0,70,70,0,1,0,1,0
1534,54369,0,0,66,66,0,1,0,1,0
10447,30317,0,0,146,146,0,1,0,1,0
55664,53,32292,53,195,102,93,2,30,1,1
65343,53,45519,53,328,99,229,4,45,2,2
64016,53,52366,53,184,94,90,2,30,1,1
59789,443,29818,443,103556,8767,94789,144,48,75,69
26941,443,39877,443,8466,3146,5320,30,20,15,15
56354,53,56354,53,214,97,117,2,30,1,1
55411,53,33954,53,183,94,89,2,30,1,1
52076,44847,0,0,66,66,0,1,0,1,0
60688,445,0,0,70,70,0,1,0,1,0
49601,53,48706,53,762,97,665,2,30,1,1
58047,80,5646,80,7453,2953,4500,19,21,10,9
10028,25604,0,0,62,62,0,1,0,1,0
48857,50584,0,0,66,66,0,1,0,1,0
52679,445,0,0,70,70,0,1,0,1,0
61744,11392,0,0,66,66,0,1,0,1,0
37604,443,27839,443,573,425,148,5,0,3,2
56328,36237,0,0,66,66,0,1,0,1,0
55525,53,56574,53,214,110,104,2,30,1,1
49901,53,54026,53,776,102,674,2,30,1,1
48189,443,41896,443,1343,616,727,14,82,7,7
58651,445,0,0,70,70,0,1,0,1,0
5955,55160,0,0,74,74,0,1,0,1,0
18683,26467,0,0,62,62,0,1,0,1,0
36379,443,4482,443,4041,2623,1418,22,94,12,10
56845,53,56845,53,825,99,726,2,30,1,1
61264,445,0,0,66,66,0,1,0,1,0
50453,80,44692,80,5978,3592,2386,15,34,8,7
61701,15503,0,0,66,66,0,1,0,1,0
21133,6889,63864,6889,481,150,331,2,1199,1,1
64947,445,0,0,70,70,0,1,0,1,0
42298,40034,23763,40034,588,86,502,2,30,1,1
26528,51221,0,0,78,78,0,1,0,1,0
36531,443,53488,443,123782,10685,113097,157,180,65,92
51986,41982,47346,41982,70,70,0,2,8,2,0
60068,443,30976,443,2227,1018,1209,17,16,8,9
40005,36237,0,0,62,62,0,1,0,1,0
27005,27016,52333,27016,892,126,766,2,30,1,1
65062,445,0,0,70,70,0,1,0,1,0
7222,57470,0,0,62,62,0,1,0,1,0
55564,80,32717,80,944,529,415,11,315,6,5
58638,5900,0,0,62,62,0,1,0,1,0
55067,53,26485,53,178,94,84,2,31,1,1
55918,53,15697,53,184,94,90,2,31,1,1
59399,53,32458,53,232,94,138,2,30,1,1
57470,38871,35688,38871,545,166,379,2,1199,1,1
50362,80,15549,80,3907,880,3027,11,15,5,6
56365,443,26003,443,3734,1750,1984,24,203,12,12
49913,53,15271,53,177,94,83,2,30,1,1
55790,53,54535,53,177,94,83,2,30,1,1
59905,443,62793,443,21212,14546,6666,43,362,24,19
59563,30188,0,0,66,66,0,1,0,1,0
59352,37965,0,0,66,66,0,1,0,1,0
36099,443,40194,443,48494,10293,38201,71,129,26,45
63196,445,0,0,66,66,0,1,0,1,0
56540,445,0,0,66,66,0,1,0,1,0
56037,53,8318,53,246,102,144,2,30,1,1
51683,5228,43500,5228,9476,2759,6717,27,3601,15,12
62373,445,0,0,66,66,0,1,0,1,0
52091,80,64640,80,2825,716,2109,12,22,7,5
9687,57470,0,0,78,78,0,1,0,1,0
47747,443,43132,443,4187,1350,2837,18,321,8,10
57542,445,0,0,66,66,0,1,0,1,0
31130,30188,0,0,66,66,0,1,0,1,0
57339,57470,0,0,66,66,0,1,0,1,0
55308,445,0,0,70,70,0,1,0,1,0
58638,5900,0,0,62,62,0,1,0,1,0
52818,445,0,0,70,70,0,1,0,1,0
54022,443,12904,443,7653,1188,6465,21,16,12,9
62996,445,0,0,70,70,0,1,0,1,0
55890,53,44710,53,193,102,91,2,31,1,1
60977,445,0,0,70,70,0,1,0,1,0
64122,53,46704,53,255,102,153,2,30,1,1
9404,443,30760,443,5693,499,5194,14,15,7,7
51532,445,0,0,70,70,0,1,0,1,0
49732,80,4505,80,2052,711,1341,10,130,6,4
64882,43890,0,0,66,66,0,1,0,1,0
56658,53,32323,53,193,102,91,2,30,1,1
17315,11392,0,0,66,66,0,1,0,1,0
30654,51221,0,0,72,72,0,1,0,1,0
1038,37965,0,0,62,62,0,1,0,1,0
49719,445,0,0,70,70,0,1,0,1,0
48478,49903,0,0,62,62,0,1,0,1,0
63001,445,0,0,70,70,0,1,0,1,0
41501,80,33952,80,306627,58973,247654,556,297,246,310
60953,445,0,0,66,66,0,1,0,1,0
56335,53,48756,53,816,102,714,2,30,1,1
51452,443,6945,443,7674,2829,4845,23,31,14,9
52065,52021,23578,52021,70,70,0,1,4,1,0
58867,443,37875,443,16230,11127,5103,69,330,34,35
49708,445,0,0,70,70,0,1,0,1,0
48230,57866,0,0,146,146,0,1,0,1,0
49690,443,64449,443,9107,2174,6933,29,187,14,15
55376,53,48930,53,789,110,679,2,31,1,1
54516,53,54516,53,235,90,145,2,33,1,1
51920,32678,28612,32678,70,70,0,1,5,1,0
59052,53,10639,53,504,110,394,2,30,1,1
50490,443,43169,443,1353,903,450,12,78,7,5
64554,53,30164,53,94,94,0,1,29,1,0
60462,47967,0,0,148,148,0,1,0,1,0
52133,15015,35766,15015,66,66,0,1,5,1,0
50694,80,52061,80,3481,1576,1905,17,187,10,7
60875,443,9147,443,45373,35377,9996,88,72,48,40
10145,21247,0,0,62,62,0,1,0,1,0
45908,3383,0,0,60,60,0,1,0,1,0
64568,443,63585,443,25404,2462,22942,47,32,25,22
47120,443,47120,443,4380,1473,2907,19,29,11,8
39916,53,62317,53,168,78,90,2,30,1,1
55706,53,23729,53,209,110,99,2,30,1,1
6828,64322,0,0,60,60,0,1,0,1,0
50556,445,0,0,70,70,0,1,0,1,0
63067,53,20594,53,384,166,218,2,30,1,1
50690,80,20479,80,4805,3639,1166,16,31,9,7
65264,53,8238,53,256,88,168,4,35,2,2
50076,445,0,0,70,70,0,1,0,1,0
52103,53733,0,0,66,66,0,1,0,1,0
50865,443,45042,443,6883,1378,5505,19,131,9,10
26944,443,13934,443,6861,2224,4637,19,19,9,10
51434,443,45613,443,12291742,358717,11933025,12485,181,3846,8639
58483,445,0,0,70,70,0,1,0,1,0
51760,443,1508,443,1569,1044,525,14,94,9,5
53306,53,0,0,86,86,0,1,29,1,0
45981,51505,0,0,62,62,0,1,0,1,0
50668,445,0,0,66,66,0,1,0,1,0
52690,7302,0,0,66,66,0,1,0,1,0
44059,443,60027,443,9730,1613,8117,24,170,11,13
50680,443,36184,443,2993,866,2127,10,120,5,5
49217,53,20500,53,209,110,99,2,29,1,1
28156,50584,0,0,62,62,0,1,0,1,0
50671,445,0,0,66,66,0,1,0,1,0
51415,443,38416,443,9284,2172,7112,39,83,19,20
49418,53,32330,53,165,86,79,2,29,1,1
56621,80,4891,80,234,234,0,4,12,4,0
54263,445,0,0,70,70,0,1,0,1,0
50966,443,44457,443,7975,3304,4671,19,86,11,8
64723,53,23544,53,677,198,479,6,68,3,3
52073,16316,19866,16316,70,70,0,2,8,2,0
55062,443,36502,443,14701,3640,11061,29,60,16,13
65023,53,44980,53,761,102,659,2,30,1,1
56656,443,24919,443,1342,918,424,10,25,6,4
57091,445,0,0,66,66,0,1,0,1,0
53719,443,48486,443,70,70,0,2,8,2,0
52425,80,64946,80,1630,918,712,12,16,7,5
64025,53,10807,53,199,94,105,2,30,1,1
64052,53,43180,53,211,102,109,2,30,1,1
65449,53,25371,53,170,87,83,2,31,1,1
65277,53,2071,53,775,102,673,2,30,1,1
46417,22114,0,0,146,146,0,1,0,1,0
10128,23718,0,0,146,146,0,1,0,1,0
56955,53,35942,53,183,94,89,2,30,1,1
9381,53,9381,53,200,90,110,2,30,1,1
50337,37965,0,0,66,66,0,1,0,1,0
25772,7302,0,0,66,66,0,1,0,1,0
65308,445,0,0,70,70,0,1,0,1,0
0,0,0,0,98,98,0,1,0,1,0
34490,443,47026,443,584,370,214,9,26,6,3
60320,443,1355,443,4679,2232,2447,15,136,7,8
54526,445,0,0,70,70,0,1,0,1,0
49855,53,19600,53,916,86,830,2,30,1,1
37991,49152,57920,49152,156,156,0,3,7,3,0
65340,53,54833,53,313,110,203,4,33,2,2
31136,50584,0,0,146,146,0,1,0,1,0
18574,56205,0,0,66,66,0,1,0,1,0
64440,53,9584,53,270,110,160,2,30,1,1
63921,445,0,0,70,70,0,1,0,1,0
50052,65010,0,0,60,60,0,1,0,1,0
52666,445,0,0,66,66,0,1,0,1,0
49870,53,59356,53,194,102,92,2,30,1,1
51291,25174,0,0,62,62,0,1,0,1,0
44912,80,52893,80,1602,1282,320,10,15,5,5
24144,57470,0,0,62,62,0,1,0,1,0
42034,28189,0,0,62,62,0,1,0,1,0
53321,445,0,0,66,66,0,1,0,1,0
45232,53,0,0,82,82,0,1,31,1,0
50321,40284,0,0,348,348,0,1,0,1,0
51935,445,0,0,70,70,0,1,0,1,0
64467,445,0,0,70,70,0,1,0,1,0
54188,445,0,0,66,66,0,1,0,1,0
49152,53,51402,53,206,105,101,2,31,1,1
42995,26467,0,0,62,62,0,1,0,1,0
57397,53,60967,53,177,94,83,2,30,1,1
35609,443,52136,443,9225,2759,6466,27,100,16,11
50470,61463,0,0,86,86,0,1,0,1,0
57470,44224,31554,44224,480,149,331,2,1200,1,1
34338,443,23040,443,8152,3395,4757,27,18,15,12
60136,56205,0,0,66,66,0,1,0,1,0
53897,46913,50139,46913,552,306,246,9,15,5,4
16948,990,0,0,60,60,0,1,0,1,0
49369,445,0,0,70,70,0,1,0,1,0
51912,443,41941,443,186,70,116,2,120,1,1
59949,44847,0,0,62,62,0,1,0,1,0
51887,445,0,0,70,70,0,1,0,1,0
58154,445,0,0,66,66,0,1,0,1,0
52156,18238,49104,18238,70,70,0,2,7,2,0
52147,30265,61743,30265,66,66,0,1,5,1,0
63931,443,46072,443,103248,6121,97127,124,144,47,77
48066,443,56844,443,62,62,0,1,4,1,0
60861,25174,0,0,66,66,0,1,0,1,0
40452,1488,40452,1488,156,156,0,3,8,3,0
21133,51413,43233,51413,460,150,310,2,1200,1,1
65045,53,53307,53,194,99,95,2,30,1,1
55439,445,0,0,70,70,0,1,0,1,0
50545,443,51366,443,9654,1771,7883,27,186,14,13
63133,445,0,0,70,70,0,1,0,1,0
56672,443,28399,443,7888,1899,5989,20,15,11,9
64432,53,49029,53,168,86,82,2,30,1,1
50582,80,50582,80,6647,4891,1756,23,21,13,10
50038,53,46782,53,177,94,83,2,31,1,1
58297,443,46075,443,7338,2419,4919,19,17,12,7
56846,26665,12553,26665,70,70,0,2,8,2,0
8414,8414,6179,8414,66,66,0,1,30,1,0
61803,445,0,0,70,70,0,1,0,1,0
51925,29587,19217,29587,70,70,0,1,5,1,0
59587,445,0,0,66,66,0,1,0,1,0
55865,53,59187,53,192,98,94,2,31,1,1
56481,80,14814,80,71347,4788,66559,83,136,34,49
61287,445,0,0,70,70,0,1,0,1,0
29291,40108,0,0,150,150,0,1,0,1,0
57871,443,42705,443,7716,3991,3725,50,125,25,25
52993,443,64908,443,16229,3316,12913,23,125,9,14
56848,53,54786,53,764,99,665,2,31,1,1
51243,445,0,0,66,66,0,1,0,1,0
45051,23,0,0,60,60,0,1,0,1,0
52683,445,0,0,66,66,0,1,0,1,0
58638,5900,0,0,62,62,0,1,0,1,0
62528,445,0,0,70,70,0,1,0,1,0
54987,443,54987,443,3154,2012,1142,16,18,10,6
58638,5900,0,0,62,62,0,1,0,1,0
54577,445,0,0,66,66,0,1,0,1,0
58638,5900,0,0,62,62,0,1,0,1,0
63469,64147,0,0,62,62,0,1,0,1,0
49202,80,38617,80,3223,605,2618,13,15,7,6
64805,445,0,0,66,66,0,1,0,1,0
51502,445,0,0,66,66,0,1,0,1,0
51449,443,58167,443,21779,7983,13796,44,97,25,19
5955,55160,0,0,74,74,0,1,0,1,0
63039,443,48295,443,448,166,282,2,29,1,1
52200,23,0,0,60,60,0,1,0,1,0
56569,53,52915,53,94,94,0,1,30,1,0
65270,3855,0,0,78,78,0,1,0,1,0
27345,53,27345,53,398,255,143,3,33,2,1
56830,53,56847,53,195,102,93,2,30,1,1
48176,50584,0,0,146,146,0,1,0,1,0
64029,53,31401,53,176,90,86,2,30,1,1
57065,53,13982,53,182,102,80,2,29,1,1
36258,23,0,0,60,60,0,1,0,1,0
50138,445,0,0,70,70,0,1,0,1,0
56979,80,46084,80,214,140,74,4,35,3,1
38320,51505,0,0,66,66,0,1,0,1,0
47969,443,44705,443,10825,4667,6158,25,159,15,10
59807,445,0,0,70,70,0,1,0,1,0
5774,37965,0,0,66,66,0,1,0,1,0
37887,22114,0,0,66,66,0,1,0,1,0
64824,37965,0,0,62,62,0,1,0,1,0
56668,80,5597,80,234,234,0,4,12,4,0
53785,33324,40281,33324,70,70,0,2,7,2,0
63589,44847,0,0,62,62,0,1,0,1,0
50095,50584,0,0,66,66,0,1,0,1,0
60569,443,44105,443,10385,4932,5453,21,135,9,12
59753,443,43725,443,303,85,218,2,30,1,1
62984,8920,64791,8920,829,583,246,9,15,5,4
50310,445,0,0,66,66,0,1,0,1,0
57441,443,53245,443,9774,3034,6740,29,19,14,15
58853,445,0,0,70,70,0,1,0,1,0
56609,443,31583,443,7982,1962,6020,20,15,11,9
57172,53,55364,53,192,98,94,2,31,1,1
59048,57470,0,0,66,66,0,1,0,1,0
37109,80,41807,80,763,434,329,8,14,5,3
64922,53,12906,53,255,102,153,2,30,1,1
56778,35440,0,0,62,62,0,1,0,1,0
57321,53,57606,53,199,102,97,2,30,1,1
38799,53,0,0,86,86,0,1,30,1,0
52086,27156,8001,27156,136,136,0,3,14,3,0
10427,32480,0,0,62,62,0,1,0,1,0
49772,80,38136,80,70,70,0,2,8,2,0
56231,445,0,0,66,66,0,1,0,1,0
49507,445,0,0,66,66,0,1,0,1,0
51320,37965,0,0,62,62,0,1,0,1,0
50396,445,0,0,70,70,0,1,0,1,0
52020,80,52020,80,6764,5555,1209,20,28,12,8
49827,443,50182,443,5863,1580,4283,17,15,9,8
49529,445,0,0,70,70,0,1,0,1,0
51414,50584,0,0,66,66,0,1,0,1,0
14903,10387,0,0,159,159,0,1,0,1,0
16387,16862,0,0,60,60,0,1,0,1,0
52601,443,40695,443,2046,1026,1020,17,80,9,8
44710,443,12033,443,13320,3575,9745,38,26,19,19
36586,80,45063,80,1114,534,580,12,15,7,5
5588,5588,0,0,3354,1792,1562,46,192,23,23
17177,64147,0,0,62,62,0,1,0,1,0
31609,25174,0,0,146,146,0,1,0,1,0
61424,443,36108,443,1119,589,530,12,28,6,6
56897,11446,0,0,66,66,0,1,0,1,0
57665,5228,43757,5228,2391,1434,957,16,3601,8,8
57493,445,0,0,70,70,0,1,0,1,0
31235,22114,0,0,146,146,0,1,0,1,0
39636,80,39636,80,4774,553,4221,13,20,6,7
57173,53,30572,53,322,110,212,4,31,2,2
59696,57470,0,0,62,62,0,1,0,1,0
49593,445,0,0,70,70,0,1,0,1,0
50899,80,61517,80,130,70,60,2,15,1,1
64124,80,34060,80,1517,481,1036,11,15,6,5
38653,21247,0,0,62,62,0,1,0,1,0
41694,443,48276,443,16107,3200,12907,35,362,17,18
49237,443,19934,443,8293,4179,4114,22,128,11,11
50584,48493,7175,48493,161,161,0,1,1200,1,0
49764,53,54622,53,199,102,97,2,30,1,1
65170,53,60576,53,771,102,669,2,30,1,1
55942,53,36132,53,197,102,95,2,30,1,1
64684,53,23170,53,199,94,105,2,30,1,1
65466,53,3496,53,733,86,647,2,31,1,1
52164,445,0,0,70,70,0,1,0,1,0
56608,445,0,0,70,70,0,1,0,1,0
50137,53,58176,53,183,94,89,2,29,1,1
59377,445,0,0,70,70,0,1,0,1,0
58638,5900,0,0,62,62,0,1,0,1,0
59477,36829,0,0,66,66,0,1,0,1,0
7372,25773,0,0,139,139,0,1,0,1,0
29263,50939,0,0,148,148,0,1,0,1,0
34273,36829,0,0,146,146,0,1,0,1,0
55976,445,0,0,70,70,0,1,0,1,0
51378,445,0,0,66,66,0,1,0,1,0
37965,51413,23143,51413,2020,1090,930,18,1200,15,3
49663,53,65385,53,195,102,93,2,30,1,1
53030,56205,0,0,66,66,0,1,0,1,0
54280,3396,54280,3396,146,60,86,2,10,1,1
27005,33070,6671,33070,883,126,757,2,31,1,1
57470,1337,56441,1337,792,792,0,13,1199,13,0
49309,443,31644,443,4250,2969,1281,23,47,12,11
61912,445,0,0,66,66,0,1,0,1,0
53713,443,10339,443,33323,3349,29974,45,123,18,27
58751,51221,0,0,62,62,0,1,0,1,0
57994,443,31591,443,10027,2130,7897,27,27,16,11
53515,39608,40902,39608,70,70,0,1,4,1,0
60612,445,0,0,70,70,0,1,0,1,0
45941,23386,0,0,60,60,0,1,0,1,0
57137,53,7336,53,711,87,624,2,30,1,1
57572,445,0,0,70,70,0,1,0,1,0
6247,51221,0,0,78,78,0,1,0,1,0
55033,53,37383,53,182,94,88,2,31,1,1
62937,30975,0,0,185,185,0,1,0,1,0
49282,53,46163,53,172,88,84,2,31,1,1
56661,443,26302,443,18375,7252,11123,47,40,24,23
52263,445,0,0,70,70,0,1,0,1,0
50237,53,53638,53,183,94,89,2,31,1,1
64647,53,58835,53,575,193,382,6,80,3,3
60557,445,0,0,70,70,0,1,0,1,0
49286,23,0,0,60,60,0,1,0,1,0
63138,51452,7117,51452,70,70,0,1,5,1,0
56625,53,47756,53,193,102,91,2,30,1,1
65315,53,36625,53,94,94,0,1,30,1,0
64068,53,64068,53,1184,83,1101,4,59,2,2
60465,445,0,0,70,70,0,1,0,1,0
54162,445,0,0,70,70,0,1,0,1,0
56221,53,42617,53,177,94,83,2,29,1,1
50008,53,59037,53,359,95,264,4,46,2,2
64747,445,0,0,70,70,0,1,0,1,0
52992,443,3497,443,97763,8230,89533,131,150,49,82
64263,445,0,0,70,70,0,1,0,1,0
35001,53,37388,53,78,78,0,1,30,1,0
64334,25174,0,0,66,66,0,1,0,1,0
65114,445,0,0,70,70,0,1,0,1,0
59759,443,40820,443,13342,1221,12121,33,41,15,18
35817,443,2802,443,3120,1862,1258,18,15,11,7
64314,445,0,0,70,70,0,1,0,1,0
51295,80,40456,80,6702,5879,823,19,135,10,9
62044,445,0,0,70,70,0,1,0,1,0
55502,445,0,0,66,66,0,1,0,1,0
51746,25174,0,0,66,66,0,1,0,1,0
59254,445,0,0,66,66,0,1,0,1,0
50861,443,62102,443,1501,590,911,12,26,6,6
59560,443,54712,443,4038,1219,2819,22,135,9,13
14489,25174,0,0,62,62,0,1,0,1,0
61472,443,58092,443,6211,1132,5079,23,88,13,10
44388,63874,0,0,66,66,0,1,0,1,0
9089,55108,0,0,148,148,0,1,0,1,0
50385,80,53379,80,28942,2526,26416,39,25,16,23
58081,3389,58081,3389,3549,1594,1955,18,16,10,8
34262,23,0,0,60,60,0,1,0,1,0
6356,26467,0,0,62,62,0,1,0,1,0
51634,80,59507,80,378,192,186,7,39,4,3
56755,53,13799,53,184,94,90,2,29,1,1
62125,445,0,0,66,66,0,1,0,1,0
37014,25174,0,0,66,66,0,1,0,1,0
60398,46776,0,0,74,74,0,1,0,1,0
50341,80,19405,80,306,180,126,6,41,4,2
49973,80,59362,80,1352,364,988,13,15,6,7
53616,44166,57712,44166,70,70,0,1,5,1,0
57086,53,59882,53,228,102,126,2,29,1,1
36538,64147,0,0,62,62,0,1,0,1,0
64052,53,55826,53,232,102,130,2,30,1,1
64080,11801,41031,11801,66,66,0,1,5,1,0
45475,161,0,0,41552,20621,20931,212,31,106,106
1530,62413,0,0,62,62,0,1,0,1,0
46555,53,62486,53,168,78,90,2,30,1,1
53797,443,48154,443,499,425,74,4,0,3,1
55252,53,15058,53,212,102,110,2,30,1,1
65058,53,6038,53,249,94,155,2,30,1,1
17777,30188,0,0,62,62,0,1,0,1,0
64809,445,0,0,66,66,0,1,0,1,0
16618,52952,0,0,146,146,0,1,0,1,0
0,0,0,0,98,98,0,1,0,1,0
56627,53,14624,53,193,102,91,2,30,1,1
55661,53,42015,53,213,102,111,2,30,1,1
56800,443,33972,443,7518,2862,4656,18,75,10,8
49911,445,0,0,66,66,0,1,0,1,0
56915,445,0,0,70,70,0,1,0,1,0
54977,80,22361,80,4259,1114,3145,12,18,8,4
49414,53,16481,53,770,102,668,2,31,1,1
56905,443,19184,443,7537,2310,5227,19,142,8,11
63503,42707,0,0,66,66,0,1,0,1,0
52238,445,0,0,70,70,0,1,0,1,0
55907,53,31154,53,184,94,90,2,29,1,1
50547,445,0,0,70,70,0,1,0,1,0
50658,443,64697,443,4876,2522,2354,22,83,13,9
57167,53,41895,53,195,102,93,2,30,1,1
65050,53,2914,53,264,102,162,2,30,1,1
37095,443,45405,443,1835,1190,645,17,26,10,7
52838,37965,0,0,66,66,0,1,0,1,0
4760,44847,0,0,62,62,0,1,0,1,0
39537,80,22901,80,903,482,421,10,360,5,5
64166,35440,0,0,66,66,0,1,0,1,0
51422,443,51422,443,4399,1492,2907,19,27,11,8
64379,37965,0,0,66,66,0,1,0,1,0
49647,53,18676,53,361,102,259,2,30,1,1
58157,445,0,0,70,70,0,1,0,1,0
65049,53,4020,53,210,110,100,2,31,1,1
57470,47099,22688,47099,330,330,0,6,1199,6,0
43743,53,43743,53,240,98,142,2,29,1,1
57017,445,0,0,66,66,0,1,0,1,0
50690,443,9122,443,152,86,66,2,4,1,1
53794,53,8818,53,260,86,174,2,30,1,1
56809,443,9000,443,7929,1909,6020,20,15,11,9
38447,443,18020,443,9824,2902,6922,38,48,19,19
32945,80,47829,80,234,234,0,4,12,4,0
53093,445,0,0,66,66,0,1,0,1,0
51372,445,0,0,70,70,0,1,0,1,0
40990,10387,0,0,148,148,0,1,0,1,0
58040,445,0,0,70,70,0,1,0,1,0
49390,53,61910,53,210,110,100,2,30,1,1
52714,445,0,0,70,70,0,1,0,1,0
53539,44847,0,0,62,62,0,1,0,1,0
64034,445,0,0,66,66,0,1,0,1,0
57043,53,58233,53,166,86,80,2,30,1,1
58755,443,8030,443,11839,7753,4086,30,17,15,15
58638,5900,0,0,62,62,0,1,0,1,0
59608,443,1997,443,2149,1277,872,18,829,10,8
55926,80,55926,80,450,246,204,8,29,5,3
41236,443,52117,443,1807,1048,759,16,25,8,8
61845,445,0,0,70,70,0,1,0,1,0
48728,80,37214,80,3524,2698,826,14,16,8,6
52064,443,64308,443,9003,2598,6405,33,345,15,18
55083,53,56476,53,216,110,106,2,30,1,1
40709,443,57804,443,256802,11839,244963,329,173,136,193
57986,445,0,0,66,66,0,1,0,1,0
49406,80,42946,80,2074,1309,765,10,124,6,4
39814,53,58386,53,168,78,90,2,30,1,1
60474,445,0,0,66,66,0,1,0,1,0
51186,445,0,0,66,66,0,1,0,1,0
64922,53,2264,53,209,102,107,2,30,1,1
27110,22114,0,0,62,62,0,1,0,1,0
65241,53,65497,53,196,100,96,2,30,1,1
53074,445,0,0,70,70,0,1,0,1,0
8999,55783,0,0,146,146,0,1,0,1,0
55875,445,0,0,66,66,0,1,0,1,0
49741,443,56871,443,6060,1553,4507,18,129,10,8
54735,443,61550,443,12507,6114,6393,30,90,18,12
55401,53,40210,53,168,86,82,2,31,1,1
57151,39004,0,0,66,66,0,1,0,1,0
60425,443,26007,443,1541,1004,537,14,26,8,6
54228,443,39518,443,499,425,74,4,0,3,1
59341,53,56377,53,187,78,109,2,30,1,1
42618,443,18541,443,4694,2432,2262,34,81,16,18
37876,5900,0,0,60,60,0,1,0,1,0
57772,443,4338,443,6783,3270,3513,22,120,11,11
54110,445,0,0,70,70,0,1,0,1,0
53138,445,0,0,70,70,0,1,0,1,0
55713,47783,26233,47783,70,70,0,1,5,1,0
64124,53,35184,53,183,94,89,2,30,1,1
49418,27016,47902,27016,245,78,167,2,30,1,1
55273,53,2212,53,168,78,90,2,30,1,1
40288,80,46706,80,1195,763,432,10,32,6,4
49883,53,5470,53,177,94,83,2,29,1,1
56052,445,0,0,70,70,0,1,0,1,0
60627,51050,0,0,66,66,0,1,0,1,0
57533,445,0,0,70,70,0,1,0,1,0
39132,44847,0,0,66,66,0,1,0,1,0
50801,445,0,0,66,66,0,1,0,1,0
58027,80,53632,80,1225,711,514,11,15,5,6
60217,443,8028,443,6075,3806,2269,18,120,10,8
54810,445,0,0,70,70,0,1,0,1,0
50895,443,43273,443,14584,6798,7786,37,181,18,19
24812,44847,0,0,146,146,0,1,0,1,0
63906,36909,1381,36909,70,70,0,1,4,1,0
46776,443,41505,443,7389,1786,5603,26,211,14,12
49479,53,55939,53,213,94,119,2,29,1,1
64749,3389,64749,3389,3347,1458,1889,15,18,8,7
8108,55108,0,0,157,157,0,1,0,1,0
50584,64027,41636,64027,166,166,0,1,1199,1,0
62711,443,43946,443,266781,12334,254447,323,161,119,204
62025,445,0,0,66,66,0,1,0,1,0
43934,443,29568,443,2548,1257,1291,15,416,8,7
49541,53,16544,53,745,215,530,6,51,3,3
54051,28793,0,0,66,66,0,1,0,1,0
63170,445,0,0,70,70,0,1,0,1,0
36414,80,15964,80,5046,4132,914,31,15,16,15
50696,445,0,0,66,66,0,1,0,1,0
443,6793,0,0,169,169,0,2,90,2,0
59683,443,7689,443,16524,4274,12250,35,133,15,20
49248,445,0,0,70,70,0,1,0,1,0
64792,53,34890,53,338,110,228,2,30,1,1
56582,37965,0,0,66,66,0,1,0,1,0
64346,445,0,0,70,70,0,1,0,1,0
61499,443,53254,443,15584,2626,12958,34,37,18,16
58570,445,0,0,70,70,0,1,0,1,0
55893,45711,0,0,78,78,0,1,0,1,0
53156,443,62340,443,3814,2664,1150,22,28,12,10
55498,53,0,0,86,86,0,1,30,1,0
443,34599,0,0,60,60,0,1,0,1,0
60260,445,0,0,66,66,0,1,0,1,0
56292,53,0,0,238,94,144,2,29,1,1
49240,53,28241,53,198,101,97,2,30,1,1
59878,443,30562,443,3864,2812,1052,17,112,8,9
55869,53,49767,53,196,102,94,2,30,1,1
52472,443,52472,443,4400,1493,2907,19,31,11,8
63625,445,0,0,70,70,0,1,0,1,0
65491,53,33767,53,193,102,91,2,31,1,1
58118,445,0,0,70,70,0,1,0,1,0
26900,27017,8503,27017,422,164,258,6,29,3,3
60162,53436,0,0,66,66,0,1,0,1,0
57927,445,0,0,70,70,0,1,0,1,0
27448,5222,60213,5222,8039,1649,6390,41,357,13,28
57432,66,52808,66,70,70,0,1,5,1,0
51444,443,39755,443,3283,951,2332,13,135,6,7
63237,445,0,0,70,70,0,1,0,1,0
55706,53,9914,53,202,103,99,2,31,1,1
55564,53,50276,53,775,103,672,2,30,1,1
59336,80,59336,80,24437,12718,11719,41,15,16,25
16037,25174,0,0,146,146,0,1,0,1,0
3976,25174,0,0,62,62,0,1,0,1,0
58058,53,63439,53,168,78,90,2,29,1,1
64733,445,0,0,70,70,0,1,0,1,0
61129,443,47713,443,3854,1233,2621,19,120,9,10
29486,53,29486,53,825,99,726,2,31,1,1
59740,445,0,0,70,70,0,1,0,1,0
65448,443,34387,443,3224,2373,851,17,23,9,8
54966,443,5878,443,4645,2498,2147,14,135,7,7
56312,53,11008,53,190,97,93,2,31,1,1
33443,443,53620,443,14402,2801,11601,28,205,11,17
50086,57470,0,0,66,66,0,1,0,1,0
60887,445,0,0,66,66,0,1,0,1,0
53113,8372,13040,8372,758,320,438,11,17,6,5
60318,80,34962,80,2714,2154,560,12,26,7,5
34677,51185,0,0,60,60,0,1,0,1,0
8889,33873,8889,33873,124,60,64,2,30,1,1
59543,445,0,0,66,66,0,1,0,1,0
53053,64147,0,0,66,66,0,1,0,1,0
59623,161,0,0,11212,5520,5692,58,30,29,29
50225,445,0,0,66,66,0,1,0,1,0
51929,53371,28667,53371,70,70,0,1,5,1,0
56893,445,0,0,66,66,0,1,0,1,0
52074,57947,9698,57947,70,70,0,1,5,1,0
50246,445,0,0,66,66,0,1,0,1,0
50236,25174,0,0,66,66,0,1,0,1,0
61772,445,0,0,66,66,0,1,0,1,0
58638,5900,0,0,62,62,0,1,0,1,0
64589,445,0,0,70,70,0,1,0,1,0
52983,445,0,0,66,66,0,1,0,1,0
44265,80,44265,80,22407,7251,15156,35,23,16,19
55010,445,0,0,70,70,0,1,0,1,0
0,0,0,0,156,156,0,2,0,2,0
59379,443,58325,443,4518,1784,2734,30,23,15,15
55584,445,0,0,70,70,0,1,0,1,0
65189,27216,23592,27216,226,71,155,2,31,1,1
23798,23,0,0,60,60,0,1,0,1,0
49282,53,18906,53,197,94,103,2,30,1,1
49413,443,21606,443,7849,1104,6745,23,123,12,11
53615,867,16773,867,70,70,0,2,7,2,0
50883,80,50883,80,514,246,268,9,42,5,4
45964,2225,0,0,60,60,0,1,0,1,0
63321,37807,0,0,66,66,0,1,0,1,0
11133,51505,0,0,66,66,0,1,0,1,0
49922,443,6981,443,11466,1320,10146,22,135,10,12
58638,5900,0,0,62,62,0,1,0,1,0
50135,445,0,0,66,66,0,1,0,1,0
63138,51452,48571,51452,70,70,0,2,8,2,0
65498,445,0,0,70,70,0,1,0,1,0
53922,445,0,0,70,70,0,1,0,1,0
51736,34343,51970,34343,70,70,0,1,5,1,0
60241,445,0,0,70,70,0,1,0,1,0
62413,445,0,0,70,70,0,1,0,1,0
48676,53393,0,0,60,60,0,1,0,1,0
49811,443,7864,443,7551,2453,5098,22,126,12,10
1903,43890,0,0,66,66,0,1,0,1,0
33328,25174,0,0,62,62,0,1,0,1,0
10151,19083,54566,19083,489,149,340,2,1200,1,1
57680,445,0,0,70,70,0,1,0,1,0
16387,8455,0,0,60,60,0,1,0,1,0
57892,445,0,0,70,70,0,1,0,1,0
54627,443,30890,443,182017,6621,175396,189,181,55,134
52358,30188,0,0,66,66,0,1,0,1,0
26058,1433,0,0,60,60,0,1,0,1,0
51933,53,51933,53,253,106,147,2,30,1,1
62414,50584,0,0,62,62,0,1,0,1,0
37213,36237,0,0,66,66,0,1,0,1,0
49638,443,58989,443,5776,1079,4697,15,52,8,7
56255,445,0,0,66,66,0,1,0,1,0
57025,445,0,0,66,66,0,1,0,1,0
53730,443,15340,443,499,425,74,4,0,3,1
55097,53,14648,53,177,94,83,2,29,1,1
49933,445,0,0,70,70,0,1,0,1,0
49178,53,11567,53,822,102,720,2,29,1,1
51087,80,58473,80,6363,3093,3270,36,130,19,17
56450,53,26592,53,170,87,83,2,30,1,1
64986,53,8227,53,180,94,86,2,30,1,1
56603,53,17293,53,179,94,85,2,30,1,1
60104,445,0,0,66,66,0,1,0,1,0
52240,445,0,0,70,70,0,1,0,1,0
60490,62336,7987,62336,504,318,186,8,15,5,3
49322,443,12551,443,166663,77974,88689,368,2310,123,245
10436,37965,0,0,62,62,0,1,0,1,0
49977,57470,0,0,62,62,0,1,0,1,0
1827,64147,0,0,66,66,0,1,0,1,0
58873,53,50618,53,168,78,90,2,30,1,1
59373,22,59373,22,295,126,169,4,1,2,2
60513,443,43919,443,9047,2015,7032,25,39,13,12
64158,53,28086,53,211,102,109,2,30,1,1
62025,445,0,0,70,70,0,1,0,1,0
58715,80,58715,80,5140,4161,979,17,28,10,7
38676,443,10906,443,5306,1619,3687,20,29,12,8
53677,10657,55902,10657,70,70,0,1,4,1,0
65246,53,4675,53,182,93,89,2,31,1,1
65234,53,35438,53,193,102,91,2,30,1,1
62885,62413,0,0,66,66,0,1,0,1,0
58295,445,0,0,70,70,0,1,0,1,0
36010,443,44715,443,5689,1505,4184,24,19,13,11
65175,53,9313,53,778,103,675,2,30,1,1
57952,443,57780,443,480591,8786,471805,442,46,102,340
46516,57470,0,0,62,62,0,1,0,1,0
54955,445,0,0,70,70,0,1,0,1,0
50868,443,26459,443,7646,1697,5949,31,271,15,16
9487,443,35248,443,5179,2934,2245,25,32,13,12
57624,445,0,0,70,70,0,1,0,1,0
49710,53,37323,53,179,94,85,2,30,1,1
53945,445,0,0,70,70,0,1,0,1,0
42164,80,6790,80,1658,1344,314,10,15,5,5
56748,35148,18439,35148,66,66,0,1,5,1,0
7619,50584,0,0,62,62,0,1,0,1,0
49883,53,18157,53,170,87,83,2,30,1,1
49846,443,49846,443,4693,1786,2907,19,27,11,8
65311,53,5309,53,198,94,104,2,30,1,1
50159,445,0,0,66,66,0,1,0,1,0
64238,53,7198,53,211,102,109,2,29,1,1
48440,53,22120,53,198,93,105,2,30,1,1
52047,42805,53752,42805,70,70,0,1,4,1,0
65274,53,10401,53,295,101,194,4,32,2,2
45941,23386,0,0,60,60,0,1,0,1,0
54471,36237,0,0,66,66,0,1,0,1,0
53685,53,0,0,547,97,450,4,40,2,2
63848,64147,0,0,66,66,0,1,0,1,0
50001,53,34185,53,239,94,145,2,29,1,1
13084,53,13084,53,224,88,136,2,30,1,1
44710,25174,0,0,62,62,0,1,0,1,0
60376,58302,44068,58302,624,318,306,10,15,5,5
37568,443,2020,443,499,425,74,4,0,3,1
49284,53,21270,53,177,94,83,2,30,1,1
56343,53,46504,53,177,94,83,2,30,1,1
2522,64147,0,0,62,62,0,1,0,1,0
56107,53,24230,53,194,102,92,2,30,1,1
53697,6224,22057,6224,70,70,0,1,4,1,0
64816,53,50725,53,166,86,80,2,30,1,1
63474,48817,0,0,66,66,0,1,0,1,0
50864,445,0,0,66,66,0,1,0,1,0
54998,53,11974,53,179,94,85,2,30,1,1
51416,445,0,0,70,70,0,1,0,1,0
50795,445,0,0,66,66,0,1,0,1,0
65077,53,33139,53,734,86,648,2,30,1,1
57947,443,8723,443,2791,1800,991,26,185,15,11
64673,53,43122,53,213,94,119,2,30,1,1
64642,53,2609,53,307,94,213,2,30,1,1
52184,22114,0,0,66,66,0,1,0,1,0
34932,38608,0,0,62,62,0,1,0,1,0
55408,445,0,0,70,70,0,1,0,1,0
57252,53,37679,53,183,94,89,2,30,1,1
50710,443,45536,443,1786,172,1614,7,120,3,4
57035,53,29329,53,199,102,97,2,30,1,1
28221,37965,0,0,62,62,0,1,0,1,0
64002,2880,57977,2880,66,66,0,2,8,2,0
33995,443,61498,443,6419,995,5424,21,361,11,10
55325,53,47399,53,199,102,97,2,29,1,1
50920,443,55566,443,6273,1375,4898,18,127,9,9
62911,36237,0,0,66,66,0,1,0,1,0
13408,44847,0,0,66,66,0,1,0,1,0
61673,445,0,0,70,70,0,1,0,1,0
65487,443,51445,443,3641,886,2755,13,136,6,7
63855,25174,0,0,62,62,0,1,0,1,0
27005,27016,28994,27016,880,126,754,2,30,1,1
52258,58792,14441,58792,316,136,180,6,8,3,3
65400,53,61482,53,211,102,109,2,30,1,1
55074,443,36824,443,3143,2172,971,19,25,9,10
55056,53,24229,53,177,94,83,2,30,1,1
64511,53,2785,53,305,102,203,2,30,1,1
55236,53,27697,53,196,102,94,2,29,1,1
11295,40040,53425,40040,213,89,124,4,54,2,2
60337,443,11026,443,1862,1223,639,18,89,11,7
49247,53,6509,53,478,196,282,6,64,3,3
58248,50584,0,0,62,62,0,1,0,1,0
63263,57470,0,0,66,66,0,1,0,1,0
50476,445,0,0,70,70,0,1,0,1,0
51949,5484,40071,5484,70,70,0,1,5,1,0
36712,53,0,0,139,70,69,2,30,1,1
49644,80,40102,80,318,192,126,6,41,4,2
57018,53,4073,53,209,110,99,2,30,1,1
34810,25174,0,0,62,62,0,1,0,1,0
55002,53,6216,53,196,102,94,2,30,1,1
56177,445,0,0,66,66,0,1,0,1,0
64219,53,37826,53,264,102,162,2,30,1,1
55226,443,25011,443,711879,19394,692485,724,98,238,486
8194,21247,0,0,62,62,0,1,0,1,0
7954,53,7954,53,226,90,136,2,29,1,1
57123,445,0,0,70,70,0,1,0,1,0
53622,61393,55834,61393,320,140,180,6,7,3,3
60392,1134,52281,1134,70,70,0,2,8,2,0
21365,23718,0,0,62,62,0,1,0,1,0
55733,51505,0,0,66,66,0,1,0,1,0
51307,445,0,0,70,70,0,1,0,1,0
50534,53,37578,53,168,86,82,2,31,1,1
57095,53,22428,53,211,110,101,2,30,1,1
11296,443,11296,443,1311,782,529,12,23,7,5
50345,53,41743,53,193,102,91,2,30,1,1
61766,443,43724,443,4326,2217,2109,14,120,7,7
33949,80,17456,80,1360,540,820,20,191,10,10
65195,445,0,0,66,66,0,1,0,1,0
55179,53,36377,53,188,96,92,2,31,1,1
49573,443,42644,443,111881,6152,105729,137,139,51,86
58638,5900,0,0,62,62,0,1,0,1,0
49982,53,19488,53,211,110,101,2,30,1,1
49861,53,27236,53,198,102,96,2,31,1,1
65224,53,46834,53,197,102,95,2,30,1,1
60524,443,60524,443,1088,641,447,10,26,6,4
57470,32348,51610,32348,527,166,361,2,1199,1,1
54201,443,42354,443,6500,1064,5436,22,255,12,10
49546,53,2512,53,357,106,251,4,36,2,2
55293,53,52510,53,230,110,120,2,30,1,1
56615,53,39007,53,177,94,83,2,29,1,1
50005,53,45437,53,295,101,194,4,30,2,2
1918,25174,0,0,66,66,0,1,0,1,0
51638,80,49602,80,19232,1830,17402,35,49,19,16
49429,443,33645,443,8861,3484,5377,19,120,9,10
10010,80,10501,80,2166,600,1566,10,45,6,4
56558,443,2694,443,7702,2155,5547,19,39,11,8
47125,8055,0,0,159,159,0,1,0,1,0
64282,53,55682,53,215,94,121,2,30,1,1
29300,35440,0,0,62,62,0,1,0,1,0
49216,53,15355,53,181,94,87,2,30,1,1
45941,23386,0,0,60,60,0,1,0,1,0
30188,13384,3738,13384,501,150,351,2,1200,1,1
51490,5223,60793,5223,9801,5352,4449,28,473,16,12
49511,80,32515,80,1693924,34466,1659458,1627,230,522,1105
60137,443,42633,443,10407,3966,6441,30,149,18,12
52614,44847,0,0,62,62,0,1,0,1,0
63752,445,0,0,70,70,0,1,0,1,0
62431,445,0,0,70,70,0,1,0,1,0
51882,445,0,0,66,66,0,1,0,1,0
65380,53,10002,53,180,94,86,2,30,1,1
57043,53,11137,53,164,84,80,2,31,1,1
49866,53,19774,53,225,110,115,2,30,1,1
36579,30188,0,0,66,66,0,1,0,1,0
27005,27016,17329,27016,883,126,757,2,30,1,1
58812,443,22392,443,5167,700,4467,16,15,7,9
65200,51050,0,0,62,62,0,1,0,1,0
60922,445,0,0,70,70,0,1,0,1,0
53811,445,0,0,66,66,0,1,0,1,0
42298,40010,41895,40010,1082,86,996,2,31,1,1
54962,445,0,0,66,66,0,1,0,1,0
63156,445,0,0,66,66,0,1,0,1,0
58638,5900,0,0,62,62,0,1,0,1,0
25348,23,0,0,60,60,0,1,0,1,0
49568,443,30225,443,6408,2531,3877,21,16,11,10
60432,445,0,0,70,70,0,1,0,1,0
29245,80,29245,80,27233,4047,23186,44,27,20,24
57301,53,28379,53,177,94,83,2,30,1,1
57257,53,41032,53,173,94,79,2,29,1,1
49538,53,59762,53,754,94,660,2,30,1,1
21294,57470,0,0,62,62,0,1,0,1,0
57586,443,39129,443,3724,1963,1761,24,95,13,11
16387,20045,0,0,60,60,0,1,0,1,0
64338,53,41701,53,200,102,98,2,30,1,1
52190,443,60064,443,570322,21029,549293,569,46,181,388
45908,33330,0,0,60,60,0,1,0,1,0
56129,445,0,0,70,70,0,1,0,1,0
60825,445,0,0,66,66,0,1,0,1,0
37138,80,13348,80,1658,1344,314,10,16,5,5
55741,445,0,0,70,70,0,1,0,1,0
49207,443,35553,443,9852,2190,7662,49,257,22,27
59586,57470,0,0,66,66,0,1,0,1,0
64986,53,17110,53,183,94,89,2,31,1,1
50180,445,0,0,66,66,0,1,0,1,0
65416,53,16237,53,213,102,111,2,30,1,1
40942,123,62465,123,184,94,90,2,30,1,1
64639,3389,64639,3389,3409,1454,1955,16,16,8,8
49573,53,10183,53,770,102,668,2,30,1,1
36227,23,0,0,60,60,0,1,0,1,0
9084,53,9084,53,224,88,136,2,30,1,1
52321,26467,0,0,62,62,0,1,0,1,0
56261,53,22541,53,184,94,90,2,31,1,1
46679,64147,0,0,62,62,0,1,0,1,0
55339,445,0,0,70,70,0,1,0,1,0
60427,61137,28150,61137,70,70,0,1,5,1,0
51842,27665,45700,27665,66,66,0,1,5,1,0
49931,53,22854,53,594,196,398,6,82,3,3
38169,443,2048,443,7841,2301,5540,18,135,8,10
57494,443,51749,443,2435128,54736,2380392,2151,346,331,1820
56192,53,2949,53,170,87,83,2,30,1,1
56641,443,17125,443,7942,1953,5989,20,15,11,9
56314,53,22045,53,183,94,89,2,30,1,1
0,0,0,0,98,98,0,1,0,1,0
55535,80,6697,80,18450,1862,16588,29,17,15,14
55549,53,31074,53,202,103,99,2,31,1,1
53971,50265,0,0,62,62,0,1,0,1,0
37002,443,19218,443,6646,2747,3899,20,134,10,10
55019,443,55019,443,3773,2325,1448,24,18,13,11
64629,445,0,0,66,66,0,1,0,1,0
36857,80,4468,80,11216,2684,8532,28,163,11,17
60813,443,60813,443,1386,751,635,15,182,8,7
55958,53,32998,53,177,94,83,2,30,1,1
60259,445,0,0,70,70,0,1,0,1,0
63727,445,0,0,70,70,0,1,0,1,0
62688,32480,0,0,109,109,0,1,0,1,0
65433,80,53822,80,486,240,246,9,28,5,4
60033,443,2482,443,4223,2828,1395,23,28,13,10
37965,63402,11159,63402,2118,858,1260,28,1283,14,14
57397,53,42342,53,256,93,163,2,31,1,1
57002,80,6505,80,214,140,74,4,35,3,1
35408,56205,0,0,66,66,0,1,0,1,0
53118,56839,5832,56839,70,70,0,2,8,2,0
56767,53,44423,53,177,94,83,2,30,1,1
56262,53,64499,53,170,87,83,2,31,1,1
64637,53,39523,53,194,102,92,2,31,1,1
49502,53,5291,53,193,102,91,2,30,1,1
50235,53,32276,53,768,99,669,2,30,1,1
15959,56205,0,0,62,62,0,1,0,1,0
56754,443,15698,443,8006,1986,6020,20,16,11,9
60135,445,0,0,70,70,0,1,0,1,0
49670,443,5760,443,886,541,345,11,15,6,5
54141,445,0,0,70,70,0,1,0,1,0
14023,37965,0,0,62,62,0,1,0,1,0
57030,53,42325,53,283,101,182,4,37,2,2
21294,57470,0,0,62,62,0,1,0,1,0
64048,44918,54494,44918,70,70,0,1,4,1,0
65501,26467,0,0,66,66,0,1,0,1,0
50618,443,39503,443,11054,1724,9330,28,91,15,13
60195,80,59592,80,70,70,0,1,5,1,0
64540,53,44077,53,352,107,245,4,37,2,2
53248,443,53248,443,1588,817,771,20,121,10,10
62984,445,0,0,66,66,0,1,0,1,0
48676,53392,0,0,60,60,0,1,0,1,0
42420,443,29433,443,8616,2683,5933,30,459,15,15
56100,53,6720,53,216,110,106,2,30,1,1
61422,80,46677,80,214,140,74,4,41,3,1
49861,445,0,0,70,70,0,1,0,1,0
20388,53,20388,53,217,90,127,2,30,1,1
57096,53,45247,53,198,102,96,2,30,1,1
43056,11119,0,0,146,146,0,1,0,1,0
40074,443,9837,443,412322,17503,394819,466,140,167,299
49295,53,60133,53,194,102,92,2,32,1,1
49645,80,12574,80,318,192,126,6,41,4,2
9605,57470,0,0,62,62,0,1,0,1,0
58774,443,50443,443,7254,838,6416,27,290,9,18
64403,53,35591,53,186,95,91,2,31,1,1
37191,48817,0,0,159,159,0,1,0,1,0
65006,53,31072,53,793,101,692,2,30,1,1
56926,53,27418,53,711,87,624,2,30,1,1
64968,53,11084,53,87,87,0,1,31,1,0
58638,5900,0,0,62,62,0,1,0,1,0
11688,23718,0,0,62,62,0,1,0,1,0
60546,445,0,0,66,66,0,1,0,1,0
14740,26467,0,0,62,62,0,1,0,1,0
39586,22114,0,0,66,66,0,1,0,1,0
63748,445,0,0,70,70,0,1,0,1,0
51728,55504,11641,55504,316,136,180,6,6,3,3
443,11266,0,0,124,124,0,1,0,1,0
51716,445,0,0,70,70,0,1,0,1,0
37647,36237,0,0,62,62,0,1,0,1,0
36738,80,36738,80,416,198,218,7,121,4,3
62486,443,21615,443,10390,7057,3333,27,33,15,12
51502,445,0,0,70,70,0,1,0,1,0
56423,80,12556,80,33937,628,33309,31,104,6,25
56403,443,13577,443,1710,976,734,16,81,8,8
52379,445,0,0,70,70,0,1,0,1,0
49651,37965,0,0,74,74,0,1,0,1,0
63980,445,0,0,70,70,0,1,0,1,0
56308,22114,0,0,146,146,0,1,0,1,0
37097,80,49884,80,1114,534,580,12,15,7,5
36908,26467,0,0,62,62,0,1,0,1,0
52963,80,22153,80,1600,581,1019,10,15,6,4
49416,443,60307,443,27484,4857,22627,42,46,15,27
2267,53,10348,53,204,118,86,2,30,1,1
55086,445,0,0,70,70,0,1,0,1,0
61347,443,30207,443,5589,2260,3329,36,217,17,19
57616,80,57616,80,266789,7684,259105,234,25,54,180
27005,1104,28939,1104,870,126,744,2,29,1,1
36953,443,22801,443,70,70,0,1,5,1,0
46478,64147,0,0,145,145,0,1,0,1,0
5611,25174,0,0,146,146,0,1,0,1,0
11136,15503,0,0,62,62,0,1,0,1,0
58367,53,2848,53,167,78,89,2,30,1,1
48909,5228,27859,5228,11007,2491,8516,44,4411,18,26
55405,53,37369,53,199,102,97,2,30,1,1
58463,443,33811,443,19057,9308,9749,111,307,53,58
47398,7302,0,0,62,62,0,1,0,1,0
60371,443,40685,443,7202,2596,4606,24,83,12,12
58638,5900,0,0,62,62,0,1,0,1,0
51773,23728,42323,23728,70,70,0,2,8,2,0
51214,445,0,0,70,70,0,1,0,1,0
3478,61463,0,0,214,214,0,1,0,1,0
57147,53,3974,53,166,86,80,2,31,1,1
54994,53,62711,53,209,110,99,2,30,1,1
44797,53,29838,53,179,86,93,2,29,1,1
56908,445,0,0,70,70,0,1,0,1,0
52097,443,17045,443,7246,3017,4229,21,15,11,10
44925,443,50958,443,153,93,60,2,5,1,1
56605,443,61768,443,7863,1874,5989,20,15,11,9
65179,53,63378,53,184,94,90,2,31,1,1
52114,64147,0,0,62,62,0,1,0,1,0
49493,80,3964,80,143422,12598,130824,226,487,52,174
54365,64147,0,0,62,62,0,1,0,1,0
49921,53,21465,53,214,110,104,2,31,1,1
60432,445,0,0,66,66,0,1,0,1,0
65165,53,53498,53,200,102,98,2,30,1,1
61280,26467,0,0,62,62,0,1,0,1,0
58017,445,0,0,70,70,0,1,0,1,0
37614,80,61486,80,1399,406,993,15,43,5,10
57573,443,57573,443,775362,32338,743024,683,180,169,514
56617,53,16257,53,286,94,192,2,30,1,1
50274,445,0,0,70,70,0,1,0,1,0
51037,445,0,0,66,66,0,1,0,1,0
55770,64147,0,0,66,66,0,1,0,1,0
50862,445,0,0,70,70,0,1,0,1,0
6355,25174,0,0,146,146,0,1,0,1,0
65246,53,33087,53,174,89,85,2,31,1,1
55955,53,59557,53,184,94,90,2,30,1,1
63157,445,0,0,70,70,0,1,0,1,0
36765,443,20693,443,27557,20627,6930,89,5581,44,45
57341,53,40485,53,296,97,199,4,41,2,2
49418,27015,20028,27015,264,78,186,2,29,1,1
36357,443,35351,443,14614,1935,12679,36,16,20,16
53379,445,0,0,70,70,0,1,0,1,0
35965,443,31855,443,3821,2814,1007,22,17,12,10
443,9986,0,0,669,669,0,1,0,1,0
54221,443,30270,443,8327,4890,3437,23,316,12,11
47132,1433,0,0,60,60,0,1,0,1,0
38660,15000,20760,15000,138,78,60,2,5,1,1
42892,443,39711,443,448,78,370,6,25,1,5
55692,53,9187,53,198,102,96,2,31,1,1
19416,23,0,0,60,60,0,1,0,1,0
53150,445,0,0,70,70,0,1,0,1,0
46495,4607,0,0,60,60,0,1,0,1,0
51922,445,0,0,70,70,0,1,0,1,0
33822,57470,0,0,66,66,0,1,0,1,0
55420,53,38783,53,177,94,83,2,30,1,1
51164,64147,0,0,62,62,0,1,0,1,0
0,0,0,0,244,244,0,2,0,2,0
56461,445,0,0,66,66,0,1,0,1,0
64082,43786,41878,43786,504,382,122,8,14,6,2
56751,32300,2097,32300,70,70,0,1,5,1,0
35232,36602,0,0,74,74,0,1,0,1,0
43303,443,47473,443,6448,1982,4466,22,16,11,11
50770,443,41782,443,6350,1369,4981,18,151,9,9
57385,80,37415,80,2546,1294,1252,17,138,9,8
54178,445,0,0,70,70,0,1,0,1,0
43516,53,56876,53,168,78,90,2,30,1,1
49397,53,28669,53,365,94,271,2,30,1,1
55688,53,51379,53,184,94,90,2,30,1,1
57441,57470,0,0,66,66,0,1,0,1,0
54649,443,1081,443,355822,186974,168848,1039,1626,433,606
26921,26467,0,0,62,62,0,1,0,1,0
52711,443,64979,443,107997,3957,104040,135,80,51,84
54592,445,0,0,70,70,0,1,0,1,0
57169,53,49234,53,177,94,83,2,30,1,1
59116,53,59116,53,203,82,121,2,30,1,1
37308,43890,0,0,62,62,0,1,0,1,0
51756,64147,0,0,66,66,0,1,0,1,0
51313,64147,0,0,62,62,0,1,0,1,0
27160,64147,0,0,62,62,0,1,0,1,0
52107,53,0,0,621,77,544,2,29,1,1
64414,53,56894,53,182,93,89,2,31,1,1
49851,53,28608,53,164,84,80,2,30,1,1
65248,53,49147,53,212,110,102,2,30,1,1
49418,27020,19032,27020,246,71,175,2,31,1,1
59271,445,0,0,66,66,0,1,0,1,0
61137,40740,0,0,145,145,0,1,0,1,0
55242,445,0,0,66,66,0,1,0,1,0
61257,56448,0,0,146,146,0,1,0,1,0
48978,25174,0,0,66,66,0,1,0,1,0
47613,53,0,0,82,82,0,1,30,1,0
57433,445,0,0,70,70,0,1,0,1,0
54825,444,0,0,60,60,0,1,0,1,0
62514,37807,0,0,66,66,0,1,0,1,0
49275,53,55214,53,283,97,186,4,30,2,2
41298,51050,0,0,62,62,0,1,0,1,0
59815,443,31852,443,4586,955,3631,17,28,9,8
27348,22114,0,0,62,62,0,1,0,1,0
43415,443,53448,443,130,70,60,2,15,1,1
65289,53,50124,53,564,193,371,6,51,3,3
52128,443,43146,443,16113,2152,13961,35,20,18,17
57371,53,5536,53,214,110,104,2,30,1,1
50431,80,44826,80,318,192,126,6,27,4,2
51800,445,0,0,70,70,0,1,0,1,0
57183,53,5484,53,199,94,105,2,29,1,1
51906,17491,64843,17491,70,70,0,2,8,2,0
57464,53,0,0,86,86,0,1,30,1,0
52079,80,61511,80,366,240,126,7,25,5,2
49842,445,0,0,66,66,0,1,0,1,0
54593,445,0,0,70,70,0,1,0,1,0
57095,53,10011,53,177,94,83,2,30,1,1
56523,445,0,0,66,66,0,1,0,1,0
57814,443,32836,443,6162,925,5237,18,108,10,8
51951,443,56049,443,6633,3485,3148,34,197,19,15
56728,53,16534,53,166,86,80,2,30,1,1
64000,14441,35024,14441,66,66,0,2,7,2,0
56979,53,46725,53,209,110,99,2,29,1,1
39674,443,32592,443,2828,1800,1028,27,184,15,12
61981,9000,0,0,60,60,0,1,0,1,0
56597,80,61984,80,234,234,0,4,12,4,0
51872,443,26165,443,442,250,192,8,30,5,3
35900,443,35900,443,5661,2414,3247,22,39,13,9
3027,53,3027,53,199,90,109,2,30,1,1
49342,53,10156,53,443,182,261,6,30,3,3
40781,443,17024,443,14327,1918,12409,37,270,17,20
49550,443,28578,443,2338,1407,931,18,200,10,8
2707,37,0,0,60,60,0,1,0,1,0
56525,443,34500,443,5022,973,4049,17,60,9,8
49510,53,6465,53,329,118,211,2,29,1,1
58638,5900,0,0,62,62,0,1,0,1,0
1024,50265,0,0,62,62,0,1,0,1,0
13285,29892,0,0,145,145,0,1,0,1,0
54631,443,52521,443,2352,1394,958,17,275,9,8
48371,443,24225,443,3908,630,3278,12,17,7,5
9103,443,27886,443,7876,1511,6365,29,42,14,15
56104,53,19874,53,210,110,100,2,30,1,1
49415,443,37841,443,9623,3235,6388,33,118,18,15
64615,445,0,0,70,70,0,1,0,1,0
51996,57470,0,0,66,66,0,1,0,1,0
51234,443,8944,443,31736,1463,30273,43,32,14,29
55159,53,20403,53,200,102,98,2,29,1,1
50472,445,0,0,66,66,0,1,0,1,0
23725,80,23725,80,1100980,31101,1069879,1210,19,462,748
53592,23578,40087,23578,70,70,0,2,7,2,0
60976,22114,0,0,66,66,0,1,0,1,0
10348,25604,0,0,66,66,0,1,0,1,0
37999,49152,14143,49152,156,156,0,3,8,3,0
55451,53,40344,53,816,102,714,2,29,1,1
12909,47807,0,0,148,148,0,1,0,1,0
64306,53,34963,53,216,110,106,2,31,1,1
56367,44847,0,0,66,66,0,1,0,1,0
55038,443,38606,443,30239,8906,21333,61,32,34,27
49817,53,12075,53,167,86,81,2,30,1,1
63593,443,12181,443,36819,3967,32852,59,152,30,29
49270,53,41673,53,735,88,647,2,30,1,1
55505,53,51745,53,199,102,97,2,31,1,1
53782,42855,41001,42855,70,70,0,2,8,2,0
64276,53,2055,53,436,89,347,4,42,2,2
55393,44512,0,0,66,66,0,1,0,1,0
59826,443,57652,443,7284,1079,6205,29,53,13,16
64513,53,5790,53,336,93,243,4,33,2,2
53710,27935,34512,27935,70,70,0,1,4,1,0
52074,80,8248,80,422,240,182,8,26,5,3
60459,445,0,0,70,70,0,1,0,1,0
52094,445,0,0,70,70,0,1,0,1,0
50543,445,0,0,70,70,0,1,0,1,0
40781,443,52827,443,448,78,370,7,20,2,5
57750,37965,0,0,146,146,0,1,0,1,0
48000,443,53560,443,7193,1890,5303,22,37,15,7
55881,443,18861,443,25586,4360,21226,57,81,29,28
58022,5601,0,0,60,60,0,1,0,1,0
42298,40026,9867,40026,212,90,122,4,30,2,2
50355,43890,0,0,66,66,0,1,0,1,0
52668,51221,0,0,66,66,0,1,0,1,0
123,123,56817,123,184,94,90,2,30,1,1
63993,17866,56109,17866,4607,2045,2562,24,45,14,10
49484,80,9940,80,3333,672,2661,12,15,7,5
50313,445,0,0,66,66,0,1,0,1,0
62651,445,0,0,70,70,0,1,0,1,0
60191,53,31189,53,196,94,102,2,31,1,1
44145,443,29432,443,8746,2844,5902,26,315,13,13
16059,22114,0,0,62,62,0,1,0,1,0
49195,445,0,0,70,70,0,1,0,1,0
61674,443,44305,443,6117,1224,4893,21,50,12,9
63399,445,0,0,70,70,0,1,0,1,0
57291,53,29680,53,178,94,84,2,30,1,1
49503,53,8833,53,167,86,81,2,30,1,1
63938,3389,63938,3389,3364,1714,1650,15,32,8,7
56821,53,37054,53,199,102,97,2,29,1,1
55163,53,35742,53,194,99,95,2,31,1,1
42453,17,0,0,60,60,0,1,0,1,0
53191,443,21271,443,7694,3364,4330,21,123,11,10
65049,53,13947,53,199,102,97,2,29,1,1
27005,27015,19164,27015,871,126,745,2,31,1,1
55946,443,34803,443,9274,5282,3992,42,186,22,20
60293,445,0,0,70,70,0,1,0,1,0
55046,80,55074,80,1056,682,374,10,16,6,4
53493,445,0,0,70,70,0,1,0,1,0
58420,53,57046,53,351,78,273,2,29,1,1
6975,29028,0,0,139,139,0,1,0,1,0
55650,53,22960,53,179,94,85,2,31,1,1
50566,445,0,0,70,70,0,1,0,1,0
49333,443,11751,443,30571,1990,28581,53,80,21,32
58814,443,65401,443,6508,4230,2278,22,16,12,10
49891,443,42695,443,8211,3683,4528,27,623,14,13
55833,53,8720,53,177,94,83,2,30,1,1
49418,27016,26183,27016,262,78,184,2,30,1,1
27005,27015,25452,27015,887,126,761,2,30,1,1
56994,53,19050,53,177,94,83,2,30,1,1
40204,40027,54251,40027,245,182,63,2,30,1,1
58427,5223,31205,5223,13841,6601,7240,42,622,19,23
63609,53,0,0,182,81,101,2,30,1,1
35080,80,13868,80,71843,2833,69010,83,16,36,47
56326,53,34552,53,177,94,83,2,30,1,1
64677,57470,0,0,66,66,0,1,0,1,0
57098,1,0,0,78,78,0,1,0,1,0
50266,443,13343,443,6344,2063,4281,26,21,12,14
55847,445,0,0,70,70,0,1,0,1,0
56752,53,39858,53,701,88,613,2,30,1,1
58638,5900,0,0,62,62,0,1,0,1,0
60993,443,45715,443,7201,2107,5094,23,61,13,10
50028,443,29629,443,15425,9901,5524,33,84,17,16
46679,64147,0,0,62,62,0,1,0,1,0
42128,80,52556,80,1139,506,633,10,15,6,4
58003,80,63884,80,14987,10571,4416,40,75,20,20
65517,443,57866,443,92117,4799,87318,107,15,43,64
51227,445,0,0,70,70,0,1,0,1,0
26900,27017,12522,27017,422,164,258,6,30,3,3
55525,445,0,0,70,70,0,1,0,1,0
62980,445,0,0,70,70,0,1,0,1,0
59737,445,0,0,70,70,0,1,0,1,0
64414,53,13029,53,183,94,89,2,29,1,1
52876,443,35265,443,501046,7967,493079,419,118,69,350
36339,50584,0,0,62,62,0,1,0,1,0
42568,443,34410,443,8049,2043,6006,23,360,11,12
56314,53,18925,53,733,86,647,2,31,1,1
46398,443,65303,443,12982,7168,5814,50,165,23,27
63981,53,63404,53,198,101,97,2,30,1,1
65048,53,7806,53,194,102,92,2,30,1,1
63030,25174,0,0,62,62,0,1,0,1,0
65376,443,34209,443,55500,40540,14960,137,131,72,65
50255,53,26984,53,199,102,97,2,30,1,1
56737,445,0,0,66,66,0,1,0,1,0
60603,445,0,0,66,66,0,1,0,1,0
53800,53,27732,53,260,86,174,2,30,1,1
64651,53,19265,53,196,94,102,2,30,1,1
49418,23010,54751,23010,288,78,210,2,30,1,1
58764,445,0,0,70,70,0,1,0,1,0
44048,443,44048,443,4401,1494,2907,19,29,11,8
56645,443,5860,443,32966,3481,29485,49,80,21,28
59984,443,19518,443,1527,940,587,14,21,8,6
56330,53,38670,53,760,97,663,2,30,1,1
56317,53,55686,53,182,93,89,2,31,1,1
56867,445,0,0,70,70,0,1,0,1,0
50031,53,6210,53,181,94,87,2,30,1,1
59214,57866,0,0,66,66,0,1,0,1,0
54894,443,28940,443,9829,2313,7516,37,25,19,18
37592,443,51917,443,9000,2566,6434,29,47,17,12
55130,25174,0,0,62,62,0,1,0,1,0
49586,53,25001,53,212,94,118,2,29,1,1
60350,443,44026,443,5242,861,4381,17,16,9,8
49931,25174,0,0,66,66,0,1,0,1,0
54942,445,0,0,70,70,0,1,0,1,0
56076,80,28614,80,5055,3100,1955,34,17,28,6
61508,445,0,0,70,70,0,1,0,1,0
59704,445,0,0,70,70,0,1,0,1,0
42974,53,0,0,82,82,0,1,30,1,0
50171,445,0,0,66,66,0,1,0,1,0
55290,445,0,0,66,66,0,1,0,1,0
64451,53,26294,53,363,92,271,4,31,2,2
16425,15503,0,0,62,62,0,1,0,1,0
49234,53,38404,53,170,87,83,2,30,1,1
52151,30692,2893,30692,70,70,0,2,8,2,0
61258,445,0,0,66,66,0,1,0,1,0
55586,23,0,0,60,60,0,1,0,1,0
50124,443,10944,443,48860,5749,43111,91,147,47,44
26900,27017,31467,27017,422,164,258,6,30,3,3
41910,443,63630,443,9358,2304,7054,39,120,20,19
53092,443,57966,443,8071,1789,6282,20,326,10,10
5588,5588,0,0,3562,1936,1626,48,193,24,24
51188,64147,0,0,62,62,0,1,0,1,0
3478,61463,0,0,441,441,0,1,0,1,0
57470,60560,62247,60560,527,166,361,2,1200,1,1
62646,445,0,0,66,66,0,1,0,1,0
61714,445,0,0,70,70,0,1,0,1,0
34408,443,19414,443,9649,3714,5935,47,340,24,23
27528,35440,0,0,66,66,0,1,0,1,0
53552,8999,43016,8999,70,70,0,1,4,1,0
57552,445,0,0,70,70,0,1,0,1,0
51142,445,0,0,70,70,0,1,0,1,0
50823,80,36399,80,35970,11674,24296,108,265,55,53
27081,10197,0,0,62,62,0,1,0,1,0
50437,445,0,0,66,66,0,1,0,1,0
55078,443,55078,443,4401,1494,2907,19,30,11,8
28385,50584,0,0,146,146,0,1,0,1,0
27988,40037,18791,40037,568,78,490,2,29,1,1
53567,43167,28309,43167,492,306,186,8,16,5,3
64771,445,0,0,70,70,0,1,0,1,0
60480,60519,7495,60519,320,140,180,6,8,3,3
64531,445,0,0,66,66,0,1,0,1,0
52094,55986,33027,55986,66,66,0,1,5,1,0
56434,445,0,0,66,66,0,1,0,1,0
56557,53,41528,53,214,110,104,2,30,1,1
50557,80,9717,80,318,192,126,6,26,4,2
6881,26296,0,0,143,143,0,1,0,1,0
57434,445,0,0,70,70,0,1,0,1,0
50436,443,10408,443,18959,3307,15652,33,19,16,17
10265,64147,0,0,66,66,0,1,0,1,0
60370,445,0,0,66,66,0,1,0,1,0
56711,53,8899,53,209,110,99,2,30,1,1
61115,445,0,0,70,70,0,1,0,1,0
57283,53,15261,53,185,102,83,2,30,1,1
52166,57975,14625,57975,70,70,0,2,8,2,0
62586,445,0,0,66,66,0,1,0,1,0
38679,443,29452,443,484912,17317,467595,550,16,229,321
17129,53,49932,53,225,78,147,2,31,1,1
55410,53,27764,53,711,87,624,2,30,1,1
48706,23393,0,0,60,60,0,1,0,1,0
63673,445,0,0,70,70,0,1,0,1,0
56000,53,42944,53,177,94,83,2,30,1,1
56728,53,8699,53,166,86,80,2,31,1,1
53287,445,0,0,70,70,0,1,0,1,0
54022,445,0,0,70,70,0,1,0,1,0
53735,443,34476,443,499,425,74,4,0,3,1
50707,53,59770,53,181,86,95,2,30,1,1
57345,443,32367,443,55537,4477,51060,81,22,38,43
53836,445,0,0,70,70,0,1,0,1,0
54393,445,0,0,66,66,0,1,0,1,0
50584,8999,10076,8999,161,161,0,1,1200,1,0
8239,37965,0,0,146,146,0,1,0,1,0
53654,445,0,0,66,66,0,1,0,1,0
43657,50011,0,0,62,62,0,1,0,1,0
56624,53,50985,53,196,102,94,2,30,1,1
64811,53,21833,53,193,102,91,2,30,1,1
52602,445,0,0,66,66,0,1,0,1,0
34998,443,4497,443,9114,2208,6906,36,120,19,17
59267,53,59267,53,222,87,135,2,31,1,1
49418,27013,52000,27013,241,78,163,2,30,1,1
59834,445,0,0,70,70,0,1,0,1,0
49761,53,14047,53,183,94,89,2,30,1,1
50415,443,63011,443,2542,1504,1038,16,20,9,7
49240,445,0,0,70,70,0,1,0,1,0
7003,53,7003,53,229,90,139,2,30,1,1
52281,161,0,0,550,550,0,6,35,6,0
42922,80,60551,80,78,78,0,1,4,1,0
50584,30773,22058,30773,1356,300,1056,6,1200,3,3
50604,443,50604,443,4401,1494,2907,19,28,11,8
62235,445,0,0,66,66,0,1,0,1,0
58638,5900,0,0,62,62,0,1,0,1,0
37008,42707,0,0,62,62,0,1,0,1,0
53726,26083,31165,26083,70,70,0,1,5,1,0
50463,445,0,0,66,66,0,1,0,1,0
56939,53,41325,53,216,110,106,2,31,1,1
13970,42873,0,0,66,66,0,1,0,1,0
55729,53,3835,53,256,96,160,4,42,2,2
61013,41705,0,0,66,66,0,1,0,1,0
52007,445,0,0,66,66,0,1,0,1,0
62338,50011,0,0,66,66,0,1,0,1,0
19617,39004,0,0,145,145,0,1,0,1,0
51927,63309,55046,63309,70,70,0,2,8,2,0
7286,44847,0,0,66,66,0,1,0,1,0
60427,61137,3652,61137,70,70,0,2,8,2,0
4793,50584,0,0,66,66,0,1,0,1,0
55821,53,65311,53,196,102,94,2,31,1,1
59937,443,7727,443,8852,1428,7424,22,199,11,11
27930,53,0,0,222,82,140,2,30,1,1
64494,53,52141,53,337,110,227,2,29,1,1
58511,53,45280,53,302,86,216,2,30,1,1
59418,443,6727,443,2946,1812,1134,16,15,8,8
55289,445,0,0,66,66,0,1,0,1,0
45319,443,29767,443,9284,2430,6854,25,82,14,11
60802,40010,3447,40010,316,136,180,6,6,3,3
61250,42873,0,0,66,66,0,1,0,1,0
27005,30010,6041,30010,887,126,761,2,31,1,1
57731,53,26408,53,237,86,151,2,30,1,1
8889,60961,0,0,60,60,0,1,0,1,0
49440,53,64789,53,415,88,327,4,52,2,2
44411,37965,0,0,62,62,0,1,0,1,0
55145,445,0,0,70,70,0,1,0,1,0
53932,445,0,0,70,70,0,1,0,1,0
36886,443,32940,443,2907,1637,1270,20,364,11,9
35809,443,51066,443,13084,2704,10380,36,201,21,15
61495,37965,0,0,66,66,0,1,0,1,0
52526,30188,0,0,62,62,0,1,0,1,0
64947,53,11296,53,275,96,179,4,41,2,2
65014,53,3896,53,186,95,91,2,31,1,1
56697,53,16898,53,198,102,96,2,29,1,1
37965,33622,23125,33622,132,132,0,3,1199,3,0
56792,42155,44462,42155,70,70,0,1,5,1,0
23218,62413,0,0,66,66,0,1,0,1,0
56909,53,4449,53,260,86,174,2,30,1,1
60445,20555,38160,20555,70,70,0,1,5,1,0
56769,53,51571,53,183,94,89,2,31,1,1
9166,53,9166,53,244,98,146,2,32,1,1
49485,11392,0,0,66,66,0,1,0,1,0
9186,80,65016,80,17643,1063,16580,26,35,11,15
56079,53,34259,53,740,93,647,2,31,1,1
37420,443,37420,443,4624,1717,2907,19,27,11,8
50150,80,7592,80,73454,5461,67993,74,79,22,52
53150,80,13371,80,2398,2024,374,12,15,6,6
53524,45395,6631,45395,70,70,0,2,8,2,0
49407,53,35774,53,774,101,673,2,30,1,1
51650,80,8862,80,2681,1044,1637,22,255,12,10
49495,443,17412,443,12452,10841,1611,26,27,14,12
38545,443,54573,443,4961,2148,2813,30,90,13,17
65332,56205,0,0,66,66,0,1,0,1,0
62687,445,0,0,66,66,0,1,0,1,0
50625,80,24486,80,8688,4248,4440,56,131,34,22
2919,37965,0,0,62,62,0,1,0,1,0
55840,53,55617,53,177,94,83,2,30,1,1
64361,53,3934,53,194,94,100,2,30,1,1
50893,445,0,0,70,70,0,1,0,1,0
49717,666,0,0,60,60,0,1,0,1,0
51296,445,0,0,66,66,0,1,0,1,0
6943,21162,0,0,100,100,0,1,0,1,0
63488,22114,0,0,62,62,0,1,0,1,0
56520,53,9113,53,177,94,83,2,29,1,1
50479,443,34516,443,5491,2608,2883,17,122,8,9
37591,443,50251,443,499,425,74,4,0,3,1
63513,53,63513,53,236,94,142,2,30,1,1
62133,445,0,0,70,70,0,1,0,1,0
65496,123,10878,123,184,94,90,2,30,1,1
58342,445,0,0,70,70,0,1,0,1,0
35760,11392,0,0,146,146,0,1,0,1,0
57289,31573,0,0,66,66,0,1,0,1,0
60602,15503,0,0,66,66,0,1,0,1,0
61282,445,0,0,66,66,0,1,0,1,0
42241,11392,0,0,66,66,0,1,0,1,0
51338,445,0,0,66,66,0,1,0,1,0
56753,44847,0,0,146,146,0,1,0,1,0
443,62732,0,0,332,332,0,1,0,1,0
58638,5900,0,0,62,62,0,1,0,1,0
56983,53,28765,53,424,108,316,4,55,2,2
56534,53,14913,53,177,94,83,2,29,1,1
53797,14550,19741,14550,320,140,180,6,5,3,3
46412,53,4555,53,164,78,86,2,31,1,1
53774,443,4137,443,499,425,74,4,0,3,1
65321,53,36858,53,167,86,81,2,29,1,1
52252,46314,0,0,62,62,0,1,0,1,0
35797,443,35797,443,4378,1471,2907,19,27,11,8
58638,5900,0,0,62,62,0,1,0,1,0
64268,53,45536,53,334,103,231,4,54,2,2
56242,53,30808,53,231,86,145,2,30,1,1
55549,53,9583,53,209,110,99,2,30,1,1
49036,44847,0,0,62,62,0,1,0,1,0
65312,53,52827,53,182,94,88,2,30,1,1
58628,445,0,0,70,70,0,1,0,1,0
26881,25174,0,0,66,66,0,1,0,1,0
53818,15337,26034,15337,164,70,94,2,4,1,1
60191,443,1843,443,7292,950,6342,19,125,9,10
59147,25174,0,0,146,146,0,1,0,1,0
55825,52700,0,0,66,66,0,1,0,1,0
64569,53,2461,53,214,102,112,2,31,1,1
54910,445,0,0,70,70,0,1,0,1,0
47894,443,29583,443,295475,14093,281382,413,469,162,251
7286,51221,0,0,62,62,0,1,0,1,0
61711,445,0,0,70,70,0,1,0,1,0
5394,23,5394,23,124,60,64,2,5,1,1
54918,445,0,0,70,70,0,1,0,1,0
37249,25174,0,0,146,146,0,1,0,1,0
57364,53,42885,53,177,94,83,2,29,1,1
57397,53,3449,53,183,94,89,2,30,1,1
49364,53,62830,53,180,92,88,2,31,1,1
49573,53,33204,53,738,86,652,2,30,1,1
56356,443,29331,443,3734,1750,1984,24,203,12,12
55585,48063,46430,48063,70,70,0,2,8,2,0
62553,445,0,0,66,66,0,1,0,1,0
56783,53,44833,53,193,102,91,2,30,1,1
65249,53,5221,53,166,86,80,2,30,1,1
57132,53,39108,53,216,110,106,2,30,1,1
48620,53,31132,53,199,94,105,2,29,1,1
62212,445,0,0,70,70,0,1,0,1,0
60665,443,60665,443,5715,1432,4283,19,15,9,10
38776,25174,0,0,146,146,0,1,0,1,0
57618,80,57618,80,265909,7294,258615,235,25,55,180
57272,445,0,0,66,66,0,1,0,1,0
47722,80,12273,80,1720,1406,314,10,15,5,5
43063,57470,0,0,62,62,0,1,0,1,0
55907,53,18391,53,184,94,90,2,31,1,1
64031,445,0,0,70,70,0,1,0,1,0
62981,445,0,0,70,70,0,1,0,1,0
28040,64147,0,0,66,66,0,1,0,1,0
56953,443,23008,443,66324,17448,48876,86,331,39,47
61104,445,0,0,70,70,0,1,0,1,0
52171,63033,49679,63033,70,70,0,2,8,2,0
59134,80,59134,80,104133,2163,101970,103,15,32,71
45908,443,37140,443,507235,15454,491781,534,136,188,346
50576,443,29225,443,7282,953,6329,18,16,10,8
62439,443,62439,443,4507,1600,2907,19,26,11,8
58520,443,24680,443,9429,3621,5808,60,80,26,34
56883,445,0,0,66,66,0,1,0,1,0
50285,443,10190,443,18009,7378,10631,58,62,33,25
52027,49743,23707,49743,70,70,0,1,4,1,0
49935,445,0,0,70,70,0,1,0,1,0
27988,40034,46189,40034,141,79,62,2,31,1,1
22683,39210,0,0,60,60,0,1,0,1,0
26651,25174,0,0,62,62,0,1,0,1,0
54334,445,0,0,70,70,0,1,0,1,0
26053,33720,0,0,160,160,0,1,0,1,0
55325,53,5383,53,199,102,97,2,30,1,1
52110,35411,30183,35411,66,66,0,1,5,1,0
50304,445,0,0,70,70,0,1,0,1,0
45908,33330,0,0,60,60,0,1,0,1,0
59076,25174,0,0,62,62,0,1,0,1,0
41220,59356,0,0,62,62,0,1,0,1,0
27005,50019,16642,50019,877,126,751,2,30,1,1
50106,30317,0,0,66,66,0,1,0,1,0
55454,53,16777,53,168,78,90,2,30,1,1
58721,443,55162,443,7973,4166,3807,28,141,14,14
64332,53,56016,53,195,102,93,2,30,1,1
49342,53,37970,53,200,102,98,2,30,1,1
52044,5824,18446,5824,70,70,0,2,8,2,0
65139,53,1458,53,216,110,106,2,30,1,1
20198,17372,0,0,62,62,0,1,0,1,0
55136,11392,0,0,66,66,0,1,0,1,0
50182,445,0,0,66,66,0,1,0,1,0
50441,80,60802,80,318,192,126,6,26,4,2
49881,445,0,0,70,70,0,1,0,1,0
57447,445,0,0,70,70,0,1,0,1,0
59563,30188,0,0,66,66,0,1,0,1,0
53682,445,0,0,66,66,0,1,0,1,0
65513,445,0,0,66,66,0,1,0,1,0
55750,53,13328,53,211,110,101,2,30,1,1
50018,53,63073,53,350,91,259,4,41,2,2
61865,35440,0,0,66,66,0,1,0,1,0
52001,80,20376,80,8117874,148550,7969324,7318,25,2033,5285
44740,443,62303,443,5954,1454,4500,22,142,13,9
16697,64147,0,0,145,145,0,1,0,1,0
62821,445,0,0,70,70,0,1,0,1,0
57169,53,55765,53,458,188,270,6,31,3,3
52904,445,0,0,70,70,0,1,0,1,0
40302,443,5180,443,7586,3785,3801,20,30,11,9
49380,53,64533,53,199,102,97,2,30,1,1
36548,443,36548,443,4621,1714,2907,19,30,11,8
33498,443,13950,443,3672,1802,1870,25,129,10,15
38664,37965,0,0,62,62,0,1,0,1,0
56697,53,7977,53,711,87,624,2,31,1,1
65121,445,0,0,66,66,0,1,0,1,0
62292,445,0,0,70,70,0,1,0,1,0
63908,33945,27378,33945,312,132,180,6,7,3,3
51439,445,0,0,66,66,0,1,0,1,0
51734,59825,48074,59825,70,70,0,1,5,1,0
64766,53,31618,53,195,102,93,2,29,1,1
3478,61463,0,0,164,164,0,1,0,1,0
53090,59356,0,0,66,66,0,1,0,1,0
49900,4500,1746,4500,78,78,0,1,5,1,0
59083,445,0,0,66,66,0,1,0,1,0
24949,47224,0,0,145,145,0,1,0,1,0
63133,80,57043,80,18055,904,17151,22,15,7,15
49944,53,37550,53,196,102,94,2,30,1,1
54519,445,0,0,66,66,0,1,0,1,0
1176,64147,0,0,62,62,0,1,0,1,0
60911,53,60911,53,216,90,126,2,30,1,1
11136,19910,0,0,62,62,0,1,0,1,0
9748,21247,0,0,66,66,0,1,0,1,0
46849,36237,0,0,62,62,0,1,0,1,0
65481,53,60374,53,168,86,82,2,30,1,1
62329,445,0,0,70,70,0,1,0,1,0
53119,58118,18768,58118,70,70,0,1,5,1,0
53739,53,43732,53,168,78,90,2,30,1,1
57591,80,57591,80,144228,2522,141706,135,144,36,99
64467,53,11977,53,184,94,90,2,30,1,1
55492,80,58922,80,164902,9835,155067,227,32,114,113
3478,61463,0,0,409,409,0,1,0,1,0
64742,53,25545,53,761,102,659,2,29,1,1
60974,443,22731,443,166465,9498,156967,220,72,100,120
56671,443,62348,443,8300,3581,4719,25,19,15,10
57020,36237,0,0,66,66,0,1,0,1,0
51511,445,0,0,70,70,0,1,0,1,0
59245,445,0,0,66,66,0,1,0,1,0
52892,443,14885,443,130,70,60,2,14,1,1
61784,49903,0,0,66,66,0,1,0,1,0
61861,445,0,0,70,70,0,1,0,1,0
42298,443,10335,443,64,64,0,1,31,1,0
49747,53,22028,53,278,94,184,2,30,1,1
53125,443,24442,443,3358,1952,1406,16,360,8,8
54238,445,0,0,70,70,0,1,0,1,0
50370,80,12726,80,318,192,126,6,28,4,2
55919,53,44823,53,177,94,83,2,30,1,1
54086,443,46250,443,4982,2205,2777,46,61,24,22
53328,53,0,0,232,77,155,2,32,1,1
53713,443,37609,443,4931,957,3974,17,15,10,7
60287,80,62692,80,1052,612,440,10,15,5,5
2323,23117,0,0,146,146,0,1,0,1,0
47729,443,6419,443,15600,2166,13434,32,205,16,16
56808,53,41016,53,90,90,0,1,30,1,0
56004,53,34719,53,177,94,83,2,30,1,1
47788,30170,0,0,146,146,0,1,0,1,0
50562,443,53886,443,103466,11111,92355,258,140,119,139
54101,445,0,0,70,70,0,1,0,1,0
62030,53,0,0,229,85,144,2,31,1,1
33624,443,6639,443,247438,52606,194832,305,237,124,181
50503,443,44653,443,9295,3094,6201,24,82,12,12
57408,53,37720,53,195,102,93,2,30,1,1
59858,443,47016,443,2069,1044,1025,22,44,9,13
51785,33253,63010,33253,70,70,0,1,5,1,0
61670,57470,0,0,74,74,0,1,0,1,0
57038,53,5859,53,186,102,84,2,31,1,1
64698,53,15508,53,763,102,661,2,30,1,1
56492,443,53818,443,6066,1016,5050,20,26,11,9
65497,53,19517,53,490,111,379,4,54,2,2
58511,50584,0,0,62,62,0,1,0,1,0
60732,443,1345,443,193520,11019,182501,280,276,140,140
53876,53380,35736,53380,70,70,0,2,8,2,0
55313,53,17189,53,198,94,104,2,29,1,1
55619,445,0,0,70,70,0,1,0,1,0
58608,62413,0,0,66,66,0,1,0,1,0
50478,445,0,0,70,70,0,1,0,1,0
49821,445,0,0,70,70,0,1,0,1,0
58955,57470,0,0,74,74,0,1,0,1,0
62536,445,0,0,66,66,0,1,0,1,0
54280,3385,0,0,60,60,0,1,0,1,0
50484,443,37149,443,30475,26737,3738,62,26,35,27
51453,64147,0,0,62,62,0,1,0,1,0
53517,48019,30847,48019,70,70,0,1,4,1,0
50682,80,30834,80,5036,4332,704,11,25,6,5
55179,53,47200,53,178,94,84,2,30,1,1
44679,80,35749,80,3180,2317,863,12,11,7,5
64744,445,0,0,66,66,0,1,0,1,0
45531,53,30846,53,168,78,90,2,30,1,1
65145,445,0,0,70,70,0,1,0,1,0
56455,53,58599,53,183,94,89,2,30,1,1
53638,443,51723,443,24895,2856,22039,46,270,22,24
55233,53,15536,53,215,102,113,2,30,1,1
50052,65008,0,0,60,60,0,1,0,1,0
52118,445,0,0,70,70,0,1,0,1,0
63033,53,19877,53,304,86,218,2,30,1,1
50907,445,0,0,70,70,0,1,0,1,0
56799,1,48991,1,316,136,180,6,6,3,3
38700,53,38476,53,164,78,86,2,30,1,1
52385,53,0,0,138,69,69,2,30,1,1
53875,43611,35716,43611,70,70,0,2,8,2,0
53987,57470,0,0,66,66,0,1,0,1,0
54545,49344,0,0,66,66,0,1,0,1,0
1066,16464,0,0,60,60,0,1,0,1,0
40800,443,27923,443,19403,4043,15360,36,48,19,17
53575,445,0,0,66,66,0,1,0,1,0
60104,30188,0,0,62,62,0,1,0,1,0
58638,5900,0,0,62,62,0,1,0,1,0
53597,445,0,0,70,70,0,1,0,1,0
49823,53,39665,53,209,110,99,2,31,1,1
4773,53,4773,53,197,90,107,2,30,1,1
62938,445,0,0,70,70,0,1,0,1,0
59147,25174,0,0,62,62,0,1,0,1,0
59979,445,0,0,66,66,0,1,0,1,0
51052,53,0,0,82,82,0,1,30,1,0
55922,53,13122,53,184,94,90,2,29,1,1
54322,27015,10656,27015,924,924,0,3,30,3,0
2467,2767,0,0,66,66,0,1,0,1,0
60852,443,55582,443,7471,2914,4557,26,47,15,11
8080,37965,0,0,62,62,0,1,0,1,0
64674,53,62663,53,183,94,89,2,29,1,1
51121,445,0,0,66,66,0,1,0,1,0
58687,11392,0,0,66,66,0,1,0,1,0
56396,443,27935,443,4239,1850,2389,25,179,12,13
58638,5900,58638,5900,62,62,0,1,5,1,0
51689,53,34111,53,198,86,112,2,30,1,1
49755,443,49571,443,447301,17016,430285,539,128,196,343
65238,53,61898,53,302,104,198,4,46,2,2
443,61686,0,0,1484,1484,0,1,0,1,0
63280,445,0,0,70,70,0,1,0,1,0
47725,443,52489,443,502,250,252,9,32,5,4
61719,445,0,0,66,66,0,1,0,1,0
61460,80,11498,80,1507,1184,323,11,79,7,4
57208,53,63369,53,182,93,89,2,31,1,1
23089,48817,0,0,62,62,0,1,0,1,0
32496,48817,0,0,148,148,0,1,0,1,0
52084,30863,5581,30863,70,70,0,1,5,1,0
53821,443,22487,443,499,425,74,4,0,3,1
57061,53,26951,53,711,87,624,2,30,1,1
64123,443,56759,443,1411,852,559,13,25,7,6
56621,443,14784,443,1327,918,409,10,26,6,4
64903,51050,0,0,66,66,0,1,0,1,0
58226,52848,0,0,145,145,0,1,0,1,0
50191,53,41237,53,182,102,80,2,29,1,1
53549,40826,14418,40826,492,306,186,8,14,5,3
64115,2767,0,0,66,66,0,1,0,1,0
58638,5900,0,0,62,62,0,1,0,1,0
64125,53,8672,53,198,101,97,2,31,1,1
60249,445,0,0,66,66,0,1,0,1,0
63535,445,0,0,70,70,0,1,0,1,0
50287,53,45385,53,177,94,83,2,30,1,1
55341,39004,0,0,74,74,0,1,0,1,0
58411,445,0,0,70,70,0,1,0,1,0
53127,30467,24380,30467,314,128,186,6,18,3,3
57072,53,34434,53,193,102,91,2,30,1,1
61950,445,0,0,70,70,0,1,0,1,0
55686,443,35273,443,319563,13365,306198,344,123,119,225
65431,53,65431,53,262,106,156,2,31,1,1
6712,161,0,0,82,82,0,1,0,1,0
27452,5222,13129,5222,3751,1007,2744,35,425,11,24
60480,57470,0,0,62,62,0,1,0,1,0
64406,53,46788,53,204,204,0,3,46,3,0
57910,443,61063,443,1853,1214,639,18,156,11,7
55605,445,0,0,70,70,0,1,0,1,0
40410,443,37656,443,2975,719,2256,14,136,7,7
63819,445,0,0,70,70,0,1,0,1,0
62473,445,0,0,70,70,0,1,0,1,0
49337,443,20876,443,3185,2263,922,18,26,9,9
56587,53,37194,53,184,94,90,2,30,1,1
60893,443,56200,443,4252,1594,2658,13,135,6,7
52402,53,52402,53,212,98,114,2,30,1,1
56082,53,1185,53,730,102,628,2,29,1,1
60199,443,24633,443,5858,1511,4347,20,21,11,9
58228,53733,0,0,66,66,0,1,0,1,0
49990,53,43468,53,198,102,96,2,30,1,1
49201,53,5443,53,200,102,98,2,31,1,1
36369,51505,0,0,66,66,0,1,0,1,0
65292,445,0,0,66,66,0,1,0,1,0
64593,53,5715,53,602,93,509,4,42,2,2
56115,53,48441,53,278,96,182,4,54,2,2
56751,53,10691,53,177,94,83,2,30,1,1
56991,445,0,0,66,66,0,1,0,1,0
51674,51505,0,0,66,66,0,1,0,1,0
58745,30188,0,0,66,66,0,1,0,1,0
58638,5900,0,0,62,62,0,1,0,1,0
59829,443,18743,443,182,60,122,4,26,2,2
51265,31652,0,0,72,72,0,1,0,1,0
50813,445,0,0,70,70,0,1,0,1,0
47700,51505,0,0,66,66,0,1,0,1,0
13525,51505,0,0,62,62,0,1,0,1,0
60433,123,65242,123,184,94,90,2,29,1,1
49635,443,49110,443,54634,6944,47690,99,47,47,52
53562,445,0,0,70,70,0,1,0,1,0
34981,80,29727,80,1658,1344,314,10,15,5,5
51315,445,0,0,70,70,0,1,0,1,0
56327,53,60019,53,199,102,97,2,30,1,1
64680,53,32256,53,768,99,669,2,30,1,1
44147,64147,0,0,62,62,0,1,0,1,0
3667,56205,0,0,62,62,0,1,0,1,0
50084,26672,0,0,62,62,0,1,0,1,0
35507,15503,0,0,62,62,0,1,0,1,0
53554,8999,45352,8999,130,70,60,2,5,1,1
64575,53,5183,53,182,102,80,2,31,1,1
46236,53,38054,53,199,94,105,2,30,1,1
49935,53,10954,53,75,75,0,1,30,1,0
50424,443,50613,443,5713,1079,4634,15,26,8,7
65020,53,8823,53,184,94,90,2,31,1,1
53122,29070,40660,29070,758,320,438,11,16,6,5
48706,23393,0,0,60,60,0,1,0,1,0
26053,33720,0,0,160,160,0,1,0,1,0
63194,50265,0,0,62,62,0,1,0,1,0
33882,80,63489,80,1454,866,588,11,58,7,4
26462,80,26462,80,490,264,226,8,32,5,3
58264,44847,0,0,66,66,0,1,0,1,0
60480,57470,0,0,62,62,0,1,0,1,0
55028,443,55949,443,6015,3964,2051,32,361,18,14
61808,443,43689,443,4625,2292,2333,14,135,7,7
22924,25174,0,0,62,62,0,1,0,1,0
30960,45730,17923,45730,330,330,0,6,3610,6,0
55479,445,0,0,66,66,0,1,0,1,0
64986,53,51778,53,734,94,640,2,29,1,1
43129,20220,0,0,62,62,0,1,0,1,0
39651,443,15343,443,18514,4506,14008,72,105,41,31
25207,48817,0,0,62,62,0,1,0,1,0
57051,53,56096,53,185,102,83,2,30,1,1
16092,50265,0,0,62,62,0,1,0,1,0
55846,53,27827,53,198,102,96,2,30,1,1
51410,445,0,0,70,70,0,1,0,1,0
59556,443,25166,443,3888,1169,2719,13,136,6,7
50867,443,26907,443,6351,1370,4981,18,131,9,9
56724,445,0,0,70,70,0,1,0,1,0
65096,443,53521,443,2414,639,1775,9,121,5,4
61148,37965,0,0,66,66,0,1,0,1,0
27005,23010,35544,23010,881,126,755,2,29,1,1
36661,443,26709,443,16244,2265,13979,35,262,19,16
63621,445,0,0,70,70,0,1,0,1,0
49730,53,24529,53,211,110,101,2,30,1,1
50827,445,0,0,70,70,0,1,0,1,0
38945,443,48637,443,20511,4206,16305,24,134,7,17
58751,51221,0,0,62,62,0,1,0,1,0
50016,53,35137,53,275,94,181,2,29,1,1
51599,443,24581,443,25546,5284,20262,48,149,26,22
57117,445,0,0,70,70,0,1,0,1,0
58396,22114,0,0,66,66,0,1,0,1,0
55797,53,20315,53,177,94,83,2,29,1,1
59013,445,0,0,70,70,0,1,0,1,0
50815,445,0,0,70,70,0,1,0,1,0
63068,445,0,0,66,66,0,1,0,1,0
3047,50584,0,0,62,62,0,1,0,1,0
48087,16069,0,0,62,62,0,1,0,1,0
57045,445,0,0,66,66,0,1,0,1,0
59191,445,0,0,70,70,0,1,0,1,0
60375,445,0,0,70,70,0,1,0,1,0
47902,443,46766,443,2420,1462,958,18,170,10,8
62566,35993,0,0,62,62,0,1,0,1,0
49508,53,17731,53,199,102,97,2,30,1,1
49690,53,14782,53,790,110,680,2,29,1,1
49243,53,10757,53,452,118,334,2,30,1,1
65189,28115,45956,28115,284,78,206,2,29,1,1
51287,26467,0,0,66,66,0,1,0,1,0
56888,443,32016,443,15807,12220,3587,44,242,18,26
57146,445,0,0,66,66,0,1,0,1,0
62356,445,0,0,70,70,0,1,0,1,0
60748,445,0,0,66,66,0,1,0,1,0
64253,53,64253,53,288,83,205,2,30,1,1
64797,80,54604,80,378,192,186,7,71,4,3
49616,30188,0,0,62,62,0,1,0,1,0
38941,443,59649,443,13623,2693,10930,22,123,10,12
53916,23505,33630,23505,70,70,0,2,7,2,0
62888,53,62888,53,240,98,142,2,29,1,1
49214,445,0,0,70,70,0,1,0,1,0
57470,44919,55339,44919,166,166,0,1,1199,1,0
49225,8080,49225,8080,43790,20134,23656,73,400,45,28
52544,445,0,0,70,70,0,1,0,1,0
50584,51651,64737,51651,166,166,0,1,1200,1,0
60633,445,0,0,70,70,0,1,0,1,0
56134,53,19695,53,167,86,81,2,30,1,1
58837,3389,58837,3389,4429,2581,1848,21,33,11,10
64315,53,11433,53,322,102,220,2,30,1,1
57275,53,22434,53,193,102,91,2,30,1,1
55998,15503,0,0,146,146,0,1,0,1,0
48817,29614,48817,29614,506,152,354,2,1201,1,1
53695,443,14454,443,4045,439,3606,11,15,5,6
64288,445,0,0,70,70,0,1,0,1,0
50584,2775,5247,2775,150,150,0,1,1200,1,0
53646,445,0,0,70,70,0,1,0,1,0
11716,37965,0,0,62,62,0,1,0,1,0
54986,53,42487,53,214,110,104,2,30,1,1
53111,50809,43690,50809,70,70,0,1,4,1,0
35667,80,40101,80,1638,1324,314,10,15,5,5
443,45940,0,0,85,85,0,1,0,1,0
55600,22,0,0,60,60,0,1,0,1,0
55013,53,63318,53,728,102,626,2,29,1,1
54059,445,0,0,70,70,0,1,0,1,0
52477,445,0,0,70,70,0,1,0,1,0
49308,53,35422,53,320,97,223,4,50,2,2
50050,53,12626,53,253,87,166,4,51,2,2
23006,48817,0,0,62,62,0,1,0,1,0
54341,443,8795,443,10046,3300,6746,23,61,14,9
49680,443,50049,443,63100,10145,52955,87,147,37,50
28999,37807,0,0,146,146,0,1,0,1,0
54105,443,23340,443,2227,1018,1209,17,16,8,9
5431,53,64205,53,220,78,142,2,30,1,1
43357,443,31552,443,6392,1099,5293,18,33,10,8
65473,53,40939,53,309,94,215,2,30,1,1
25565,2216,0,0,60,60,0,1,0,1,0
37383,443,62473,443,11389,4837,6552,27,120,13,14
53018,80,53018,80,182677,4908,177769,213,25,73,140
50635,443,12337,443,8252,1702,6550,26,72,13,13
60100,445,0,0,66,66,0,1,0,1,0
49631,53,31277,53,196,100,96,2,31,1,1
42632,443,43354,443,4299,1870,2429,17,150,8,9
65179,53,52575,53,184,94,90,2,30,1,1
41156,53,41156,53,216,82,134,2,31,1,1
47918,123,27276,123,184,94,90,2,30,1,1
49958,36829,0,0,66,66,0,1,0,1,0
53294,445,0,0,70,70,0,1,0,1,0
59820,445,0,0,70,70,0,1,0,1,0
45941,23386,0,0,60,60,0,1,0,1,0
24910,64147,0,0,66,66,0,1,0,1,0
59865,443,51225,443,502,250,252,9,26,5,4
50081,57470,0,0,66,66,0,1,0,1,0
50140,53,17472,53,209,110,99,2,30,1,1
54280,3385,0,0,60,60,0,1,0,1,0
64087,445,0,0,70,70,0,1,0,1,0
63460,55160,0,0,62,62,0,1,0,1,0
61520,23718,0,0,66,66,0,1,0,1,0
65287,53,16028,53,180,94,86,2,30,1,1
56430,445,0,0,70,70,0,1,0,1,0
51295,445,0,0,66,66,0,1,0,1,0
21833,22114,0,0,62,62,0,1,0,1,0
51507,443,1531,443,584465,23057,561408,694,36,303,391
57444,53,22248,53,170,87,83,2,30,1,1
64750,53,24687,53,193,102,91,2,29,1,1
64685,53,52958,53,186,95,91,2,30,1,1
57475,445,0,0,70,70,0,1,0,1,0
51104,445,0,0,66,66,0,1,0,1,0
50700,445,0,0,70,70,0,1,0,1,0
7720,44847,0,0,66,66,0,1,0,1,0
49558,53,38507,53,193,102,91,2,29,1,1
60335,445,0,0,70,70,0,1,0,1,0
57445,66,60334,66,70,70,0,1,5,1,0
9315,443,40509,443,3649,424,3225,12,15,6,6
49660,53,56463,53,193,102,91,2,31,1,1
50236,443,16316,443,4954,1768,3186,18,143,9,9
42488,53,42488,53,235,90,145,2,32,1,1
3717,25174,0,0,62,62,0,1,0,1,0
56945,53,62206,53,180,94,86,2,30,1,1
38691,443,60473,443,90369,3417,86952,95,15,30,65
58638,5900,0,0,62,62,0,1,0,1,0
57413,445,0,0,66,66,0,1,0,1,0
35589,25174,0,0,66,66,0,1,0,1,0
48015,443,45822,443,19394,2961,16433,51,196,24,27
5938,35070,0,0,60,60,0,1,90,1,0
64679,53,32723,53,328,88,240,4,32,2,2
55277,53,53790,53,701,88,613,2,30,1,1
49678,445,0,0,70,70,0,1,0,1,0
443,54507,0,0,82,82,0,1,0,1,0
56629,25174,0,0,66,66,0,1,0,1,0
56903,53,50850,53,232,94,138,2,30,1,1
33640,53,0,0,138,69,69,2,30,1,1
55335,445,0,0,70,70,0,1,0,1,0
50253,53,9014,53,756,95,661,2,30,1,1
61656,445,0,0,66,66,0,1,0,1,0
63471,445,0,0,70,70,0,1,0,1,0
62050,443,9772,443,2139,1140,999,15,124,9,6
56260,445,0,0,66,66,0,1,0,1,0
50643,80,56301,80,5660,3544,2116,17,47,10,7
64801,53,33594,53,728,96,632,2,30,1,1
56660,80,51147,80,234,234,0,4,12,4,0
54969,53,12796,53,199,102,97,2,29,1,1
39742,62413,0,0,66,66,0,1,0,1,0
58012,5555,0,0,60,60,0,1,0,1,0
27005,27019,52593,27019,1007,252,755,4,32,3,1
15235,36237,0,0,62,62,0,1,0,1,0
51848,80,47789,80,12009,5364,6645,23,31,12,11
65114,53,27541,53,196,102,94,2,31,1,1
49826,53,60102,53,466,192,274,6,83,3,3
1574,50584,0,0,62,62,0,1,0,1,0
8082,53,8082,53,237,91,146,2,33,1,1
1262,23,0,0,60,60,0,1,0,1,0
55010,53,42242,53,195,102,93,2,29,1,1
51209,443,1552,443,11983,2674,9309,51,17,29,22
0,0,0,0,480,244,236,4,0,2,2
64455,445,0,0,70,70,0,1,0,1,0
64636,53,4639,53,325,102,223,2,30,1,1
56380,36829,0,0,66,66,0,1,0,1,0
37116,80,37116,80,2971,1509,1462,10,15,6,4
26406,37965,0,0,66,66,0,1,0,1,0
52006,443,14012,443,2898,2047,851,19,22,11,8
5588,5588,0,0,3562,1936,1626,48,196,24,24
65047,53,60656,53,184,102,82,2,30,1,1
62055,445,0,0,70,70,0,1,0,1,0
55044,53,47229,53,168,78,90,2,30,1,1
56629,53,37533,53,177,94,83,2,30,1,1
11716,37965,0,0,62,62,0,1,0,1,0
64847,22114,0,0,66,66,0,1,0,1,0
42298,40036,28327,40036,205,83,122,4,29,2,2
50470,61463,0,0,86,86,0,1,0,1,0
3225,64147,0,0,66,66,0,1,0,1,0
1024,64147,0,0,62,62,0,1,0,1,0
51026,445,0,0,70,70,0,1,0,1,0
57147,53,63811,53,166,86,80,2,29,1,1
51244,42416,0,0,100,100,0,1,0,1,0
50438,53,48155,53,295,101,194,4,31,2,2
64880,64147,0,0,62,62,0,1,0,1,0
52176,17572,9912,17572,70,70,0,1,5,1,0
61417,80,18297,80,214,140,74,4,55,3,1
55190,445,0,0,70,70,0,1,0,1,0
57143,445,0,0,66,66,0,1,0,1,0
55084,445,0,0,70,70,0,1,0,1,0
49351,53,27652,53,166,86,80,2,30,1,1
49188,53,21489,53,777,87,690,2,31,1,1
61884,445,0,0,70,70,0,1,0,1,0
51911,445,0,0,66,66,0,1,0,1,0
48012,443,51500,443,1429,1295,134,10,29,8,2
46662,36237,0,0,62,62,0,1,0,1,0
56388,22114,0,0,66,66,0,1,0,1,0
55355,445,0,0,66,66,0,1,0,1,0
59504,445,0,0,70,70,0,1,0,1,0
61868,445,0,0,70,70,0,1,0,1,0
46567,443,52746,443,6407,984,5423,21,360,11,10
48187,443,22685,443,1515,568,947,14,82,6,8
25360,51505,0,0,62,62,0,1,0,1,0
51596,445,0,0,70,70,0,1,0,1,0
57661,53,46284,53,70,70,0,1,30,1,0
53757,445,0,0,70,70,0,1,0,1,0
55700,26957,33294,26957,70,70,0,2,8,2,0
25565,27960,0,0,60,60,0,1,0,1,0
63584,443,24147,443,3182,1568,1614,8,120,4,4
50700,80,27825,80,142,142,0,1,5,1,0
56750,80,10595,80,194,128,66,4,25,3,1
54926,445,0,0,66,66,0,1,0,1,0
6886,45378,0,0,139,139,0,1,0,1,0
52027,445,0,0,66,66,0,1,0,1,0
52264,445,0,0,70,70,0,1,0,1,0
24411,12809,0,0,60,60,0,1,0,1,0
56635,80,4559,80,234,234,0,4,12,4,0
56912,443,18350,443,7618,2859,4759,26,17,14,12
58228,53733,0,0,62,62,0,1,0,1,0
11458,2767,0,0,66,66,0,1,0,1,0
49924,445,0,0,66,66,0,1,0,1,0
24073,22114,0,0,62,62,0,1,0,1,0
62106,445,0,0,70,70,0,1,0,1,0
60789,40010,35327,40010,316,136,180,6,6,3,3
26900,27017,1315,27017,422,164,258,6,30,3,3
49926,445,0,0,70,70,0,1,0,1,0
57928,445,0,0,66,66,0,1,0,1,0
10947,53,10947,53,197,90,107,2,29,1,1
49339,443,48962,443,3191,2313,878,17,42,10,7
65502,445,0,0,70,70,0,1,0,1,0
45694,80,47472,80,154671,9533,145138,227,38,121,106
63015,445,0,0,70,70,0,1,0,1,0
65155,53,9340,53,613,200,413,6,59,3,3
25510,48817,0,0,140,140,0,1,0,1,0
55489,53,34902,53,748,106,642,2,31,1,1
55311,44847,0,0,62,62,0,1,0,1,0
56909,50584,0,0,66,66,0,1,0,1,0
38731,443,59272,443,13181,5856,7325,23,135,11,12
45964,55559,0,0,60,60,0,1,0,1,0
6247,51221,0,0,78,78,0,1,0,1,0
1081,43109,0,0,146,146,0,1,0,1,0
50772,445,0,0,70,70,0,1,0,1,0
53526,445,0,0,66,66,0,1,0,1,0
55865,53,34168,53,807,94,713,2,30,1,1
65262,53,31670,53,216,110,106,2,30,1,1
64959,53,12491,53,209,110,99,2,30,1,1
19962,53,19962,53,832,106,726,2,30,1,1
64940,26467,0,0,62,62,0,1,0,1,0
0,0,0,0,244,244,0,2,0,2,0
49384,53,22527,53,193,102,91,2,29,1,1
6881,35894,0,0,62,62,0,1,0,1,0
51067,445,0,0,70,70,0,1,0,1,0
58901,443,21819,443,5168,700,4468,16,15,7,9
27005,27017,10381,27017,600,126,474,2,30,1,1
443,48346,0,0,81,81,0,1,0,1,0
20954,53,64122,53,223,78,145,2,30,1,1
57234,21247,0,0,66,66,0,1,0,1,0
60901,443,60901,443,24367,4634,19733,52,49,26,26
39195,25174,0,0,62,62,0,1,0,1,0
50293,445,0,0,66,66,0,1,0,1,0
49840,53,47224,53,463,87,376,4,38,2,2
38135,443,62915,443,2568507,98538,2469969,2956,65,1228,1728
62172,445,0,0,66,66,0,1,0,1,0
60874,445,0,0,66,66,0,1,0,1,0
51046,25174,0,0,66,66,0,1,0,1,0
48550,443,45303,443,778,358,420,12,43,6,6
59422,51221,0,0,66,66,0,1,0,1,0
55667,19667,52444,19667,70,70,0,2,8,2,0
63980,53,48933,53,225,102,123,2,30,1,1
46140,443,48726,443,172,172,0,2,5,2,0
38971,25174,0,0,146,146,0,1,0,1,0
63599,445,0,0,66,66,0,1,0,1,0
49560,443,58104,443,13516,6981,6535,61,2149,34,27
65264,53,54273,53,88,88,0,1,30,1,0
42903,53,55150,53,168,78,90,2,30,1,1
21534,42246,0,0,66,66,0,1,0,1,0
443,12105,0,0,66,66,0,1,0,1,0
51692,445,0,0,70,70,0,1,0,1,0
55049,53,52659,53,733,86,647,2,31,1,1
1935,53,17873,53,260,86,174,2,30,1,1
57432,53,57432,53,247,98,149,2,34,1,1
52072,25595,25464,25595,70,70,0,2,8,2,0
5588,5588,0,0,3562,1936,1626,48,194,24,24
59447,445,0,0,70,70,0,1,0,1,0
19626,3389,19626,3389,293,223,70,4,0,3,1
50265,56845,47720,56845,480,149,331,2,1200,1,1
49742,53,16673,53,216,110,106,2,30,1,1
55056,44512,0,0,62,62,0,1,0,1,0
2267,53,46205,53,204,118,86,2,31,1,1
50494,80,52508,80,18059,13615,4444,29,27,16,13
34952,53,65291,53,177,94,83,2,30,1,1
50394,25174,0,0,62,62,0,1,0,1,0
49428,445,0,0,66,66,0,1,0,1,0
50537,80,34758,80,4186,3559,627,15,31,8,7
58476,443,24063,443,25370,5607,19763,40,138,18,22
43578,15503,0,0,74,74,0,1,0,1,0
54796,22114,0,0,66,66,0,1,0,1,0
62691,445,0,0,70,70,0,1,0,1,0
42951,44847,0,0,66,66,0,1,0,1,0
53353,26467,0,0,62,62,0,1,0,1,0
56745,443,12454,443,8058,2038,6020,20,15,11,9
57323,53,38814,53,194,102,92,2,31,1,1
54867,445,0,0,70,70,0,1,0,1,0
56500,53,60506,53,199,102,97,2,30,1,1
56669,443,61657,443,8058,2038,6020,20,15,11,9
51765,80,50481,80,5569,3270,2299,21,74,13,8
64873,445,0,0,66,66,0,1,0,1,0
60600,445,0,0,70,70,0,1,0,1,0
54118,443,16400,443,3182,1568,1614,8,120,4,4
55770,53,28096,53,167,86,81,2,29,1,1
33784,443,3722,443,2378,1126,1252,14,979,7,7
62905,445,0,0,70,70,0,1,0,1,0
50358,443,36799,443,1786,172,1614,7,121,3,4
52100,54130,10499,54130,70,70,0,2,8,2,0
46212,443,38830,443,67265,57889,9376,174,102,98,76
1620,53567,0,0,66,66,0,1,0,1,0
19875,30170,0,0,145,145,0,1,0,1,0
52011,80,26180,80,23580,10536,13044,36,39,18,18
49497,445,0,0,70,70,0,1,0,1,0
27005,27015,49303,27015,868,126,742,2,30,1,1
65524,53,9019,53,386,122,264,4,52,2,2
49908,56205,0,0,62,62,0,1,0,1,0
57356,443,4225,443,7802,4189,3613,22,136,11,11
63787,445,0,0,70,70,0,1,0,1,0
38264,443,28661,443,134,60,74,3,4,2,1
57421,80,60577,80,4507,2978,1529,13,15,6,7
50862,443,25283,443,1501,590,911,12,26,6,6
59878,53,26296,53,391,102,289,2,29,1,1
50848,445,0,0,66,66,0,1,0,1,0
27947,26467,0,0,62,62,0,1,0,1,0
3694,80,3582,80,6919,1220,5699,20,104,12,8
443,61686,0,0,1484,1484,0,1,0,1,0
65437,53,48894,53,1386,85,1301,4,53,2,2
51797,80,9284,80,1929,796,1133,21,135,11,10
52288,443,59643,443,38314,11683,26631,76,34,38,38
35100,11392,0,0,62,62,0,1,0,1,0
51732,445,0,0,70,70,0,1,0,1,0
64515,53,64413,53,231,86,145,2,30,1,1
64784,53,28832,53,195,102,93,2,29,1,1
59187,445,0,0,70,70,0,1,0,1,0
58922,443,2924,443,14553,9653,4900,38,19,22,16
57676,64147,0,0,74,74,0,1,0,1,0
56381,51505,0,0,62,62,0,1,0,1,0
49541,443,61178,443,8464,2891,5573,20,30,10,10
48282,8080,0,0,184,78,106,3,9,2,1
9238,80,17779,80,378,192,186,7,26,4,3
56719,53,59269,53,185,102,83,2,30,1,1
55427,53,22421,53,200,102,98,2,33,1,1
44505,53,44505,53,216,90,126,2,30,1,1
52112,22114,0,0,66,66,0,1,0,1,0
57470,51413,6363,51413,493,166,327,2,1200,1,1
59962,53,13839,53,316,94,222,2,30,1,1
63232,443,26677,443,4496,2346,2150,28,124,15,13
64817,53,59265,53,199,94,105,2,29,1,1
56496,53,36684,53,164,86,78,2,29,1,1
58796,443,44743,443,14463,9503,4960,34,17,17,17
51603,443,54804,443,19849,6817,13032,45,37,23,22
56559,53,15416,53,731,85,646,2,30,1,1
56510,445,0,0,70,70,0,1,0,1,0
56501,53,9977,53,216,94,122,2,31,1,1
55218,443,17111,443,17915,7421,10494,39,61,21,18
58869,443,38937,443,4657,2146,2511,14,135,7,7
55451,56205,0,0,66,66,0,1,0,1,0
64001,53,1260,53,183,94,89,2,30,1,1
14613,12446,0,0,66,66,0,1,0,1,0
51554,443,48017,443,4263,671,3592,14,75,8,6
49810,80,21965,80,1469,979,490,10,125,6,4
42298,40030,21853,40030,546,486,60,2,30,1,1
55545,53,10302,53,170,87,83,2,30,1,1
51499,445,0,0,66,66,0,1,0,1,0
50903,80,4352,80,8600,1437,7163,18,144,10,8
36339,50584,0,0,146,146,0,1,0,1,0
60380,443,29465,443,70,70,0,1,5,1,0
56250,36237,0,0,66,66,0,1,0,1,0
58402,445,0,0,66,66,0,1,0,1,0
64036,23718,0,0,66,66,0,1,0,1,0
57599,80,28045,80,808,485,323,8,75,5,3
58569,445,0,0,66,66,0,1,0,1,0
57464,80,36285,80,234,234,0,4,11,4,0
58326,50584,0,0,62,62,0,1,0,1,0
0,0,0,0,600,306,294,6,0,3,3
45354,443,16907,443,81504,6111,75393,108,20,53,55
55678,5618,0,0,145,145,0,1,0,1,0
11964,53,13321,53,268,94,174,2,30,1,1
60196,53,0,0,88,88,0,1,0,1,0
52108,20175,5769,20175,70,70,0,2,8,2,0
21674,28189,0,0,60,60,0,1,0,1,0
55669,62781,37625,62781,320,140,180,6,7,3,3
49919,53,2531,53,225,102,123,2,30,1,1
443,37338,0,0,118,118,0,1,0,1,0
61038,445,0,0,66,66,0,1,0,1,0
52269,445,0,0,66,66,0,1,0,1,0
55505,53,30588,53,199,102,97,2,31,1,1
49603,53,64849,53,733,94,639,2,30,1,1
53756,445,0,0,66,66,0,1,0,1,0
51156,53,46247,53,168,78,90,2,29,1,1
56070,53,26270,53,193,102,91,2,30,1,1
50620,50584,0,0,66,66,0,1,0,1,0
3883,50265,0,0,66,66,0,1,0,1,0
55633,54638,31495,54638,504,318,186,8,15,5,3
49501,11392,0,0,66,66,0,1,0,1,0
55613,445,0,0,70,70,0,1,0,1,0
61193,445,0,0,66,66,0,1,0,1,0
64166,445,0,0,66,66,0,1,0,1,0
59755,44512,0,0,66,66,0,1,0,1,0
64792,443,39397,443,16199,7657,8542,58,127,28,30
58570,445,0,0,66,66,0,1,0,1,0
61461,443,61461,443,19070,4830,14240,33,18,18,15
15806,11392,0,0,66,66,0,1,0,1,0
58999,443,30350,443,2687,1593,1094,20,20,11,9
7226,50584,0,0,62,62,0,1,0,1,0
30111,2323,0,0,60,60,0,1,0,1,0
37748,80,57196,80,1090,609,481,13,329,7,6
55285,53,22135,53,268,95,173,4,45,2,2
3891,53,3891,53,235,90,145,2,32,1,1
63096,44847,0,0,66,66,0,1,0,1,0
9017,6881,0,0,62,62,0,1,0,1,0
58020,445,0,0,70,70,0,1,0,1,0
49696,445,0,0,66,66,0,1,0,1,0
2267,53,35940,53,204,118,86,2,30,1,1
49218,53,62258,53,190,97,93,2,31,1,1
55627,53,32877,53,179,94,85,2,30,1,1
45202,443,49520,443,15153,8118,7035,45,271,22,23
50552,443,41023,443,8311,3156,5155,29,17,16,13
50026,445,0,0,70,70,0,1,0,1,0
47461,50584,0,0,62,62,0,1,0,1,0
34988,80,55946,80,416,210,206,7,28,4,3
55651,53,20940,53,199,102,97,2,30,1,1
9448,57866,0,0,146,146,0,1,0,1,0
52749,64147,0,0,66,66,0,1,0,1,0
55293,53,0,0,166,73,93,2,30,1,1
49198,64509,42217,64509,70,70,0,2,8,2,0
49910,445,0,0,70,70,0,1,0,1,0
52955,443,44904,443,3617,2035,1582,30,346,15,15
27055,25174,0,0,146,146,0,1,0,1,0
53915,1026,61852,1026,70,70,0,1,5,1,0
36656,64147,0,0,62,62,0,1,0,1,0
64388,53,41426,53,258,110,148,2,30,1,1
46744,53,46744,53,404,259,145,3,32,2,1
62900,445,0,0,66,66,0,1,0,1,0
51252,443,8705,443,9600,4628,4972,41,16,24,17
56256,62413,0,0,62,62,0,1,0,1,0
34731,22114,0,0,146,146,0,1,0,1,0
6703,21247,0,0,62,62,0,1,0,1,0
64104,53,19823,53,288,101,187,4,57,2,2
49944,53,20178,53,192,98,94,2,31,1,1
56786,443,23041,443,7929,1940,5989,20,16,11,9
59977,53,61405,53,168,78,90,2,30,1,1
49296,443,51414,443,7419,2173,5246,17,16,9,8
38280,80,34023,80,748,459,289,8,254,5,3
38643,443,16669,443,2540,1317,1223,17,28,9,8
49986,445,0,0,70,70,0,1,0,1,0
52319,445,0,0,70,70,0,1,0,1,0
53873,443,46663,443,499,425,74,4,1,3,1
1024,22114,0,0,146,146,0,1,0,1,0
21322,25174,0,0,62,62,0,1,0,1,0
53477,443,34084,443,21476,1330,20146,32,137,12,20
46330,56205,0,0,146,146,0,1,0,1,0
49418,32056,18212,32056,245,78,167,2,30,1,1
61377,445,0,0,70,70,0,1,0,1,0
49604,53,12616,53,179,94,85,2,30,1,1
2077,53,2077,53,212,98,114,2,30,1,1
33405,37965,0,0,62,62,0,1,0,1,0
30188,12494,61043,12494,502,150,352,2,1200,1,1
56560,53,34693,53,196,100,96,2,31,1,1
60213,445,0,0,70,70,0,1,0,1,0
49196,25174,0,0,62,62,0,1,0,1,0
58638,5900,0,0,62,62,0,1,0,1,0
52916,80,53748,80,4266,1776,2490,20,367,11,9
56196,53,24743,53,498,204,294,6,31,3,3
54326,7000,54326,7000,2958,1567,1391,15,15,8,7
36966,10387,0,0,159,159,0,1,0,1,0
61033,445,0,0,70,70,0,1,0,1,0
39851,443,44930,443,9355,3422,5933,56,16,28,28
52260,52142,32000,52142,70,70,0,2,8,2,0
65425,53,4149,53,402,142,260,2,30,1,1
34613,80,39992,80,1013,504,509,10,17,6,4
61430,37965,0,0,66,66,0,1,0,1,0
50638,443,50638,443,4544,1637,2907,19,26,11,8
37715,53,37715,53,235,90,145,2,32,1,1
51490,1,0,0,100,100,0,1,0,1,0
57578,443,34885,443,13999,3478,10521,33,134,15,18
63888,57470,0,0,62,62,0,1,0,1,0
63018,53,50611,53,384,166,218,2,29,1,1
52110,80,18812,80,422,240,182,8,26,5,3
57110,445,0,0,70,70,0,1,0,1,0
55674,53,14625,53,744,89,655,2,31,1,1
50047,443,14680,443,4612,947,3665,18,85,10,8
49835,53,4123,53,250,86,164,4,30,2,2
64624,445,0,0,66,66,0,1,0,1,0
49196,443,53527,443,789207,20847,768360,812,23,294,518
55282,445,0,0,70,70,0,1,0,1,0
53932,27258,53010,27258,70,70,0,1,5,1,0
58638,5900,0,0,62,62,0,1,0,1,0
54794,445,0,0,70,70,0,1,0,1,0
9552,22114,0,0,146,146,0,1,0,1,0
59192,445,0,0,66,66,0,1,0,1,0
53959,445,0,0,66,66,0,1,0,1,0
3290,57470,0,0,145,145,0,1,0,1,0
64156,445,0,0,70,70,0,1,0,1,0
56876,443,56876,443,18542,1778,16764,30,17,15,15
57026,445,0,0,70,70,0,1,0,1,0
39890,443,4730,443,21106,2445,18661,45,20,24,21
60408,55557,44331,55557,70,70,0,2,8,2,0
53105,445,0,0,70,70,0,1,0,1,0
59376,5900,0,0,60,60,0,1,0,1,0
39538,80,23642,80,2191,1142,1049,21,370,9,12
65452,53,19191,53,196,102,94,2,30,1,1
55958,53,40832,53,177,94,83,2,30,1,1
63562,445,0,0,70,70,0,1,0,1,0
53309,445,0,0,70,70,0,1,0,1,0
52111,44847,0,0,66,66,0,1,0,1,0
45941,23388,0,0,60,60,0,1,0,1,0
53263,445,0,0,70,70,0,1,0,1,0
60776,4156,29632,4156,66,66,0,1,5,1,0
57325,37965,0,0,62,62,0,1,0,1,0
43931,53,36161,53,168,78,90,2,31,1,1
64803,53,39873,53,102,102,0,1,30,1,0
41664,53,40771,53,376,78,298,2,30,1,1
59371,161,59371,161,2085,880,1205,10,31,5,5
27005,27016,8684,27016,898,126,772,2,31,1,1
45077,443,32205,443,6533,1777,4756,24,271,13,11
58771,80,64938,80,2062,904,1158,10,258,6,4
40151,5228,21276,5228,19172,3089,16083,43,3601,20,23
49527,53,33639,53,173,94,79,2,30,1,1
49950,80,40840,80,51651,48866,2785,74,20,38,36
49744,80,34902,80,1111,749,362,9,15,5,4
10669,49756,0,0,60,60,0,1,0,1,0
50919,445,0,0,66,66,0,1,0,1,0
51653,80,24193,80,454,262,192,8,37,5,3
55311,53,55274,53,298,101,197,4,31,2,2
59919,53,59919,53,231,90,141,2,31,1,1
38632,443,3130,443,9606,1228,8378,20,115,9,11
57318,53,50520,53,418,88,330,4,41,2,2
49511,443,49511,443,150713,27113,123600,199,82,104,95
46573,50584,0,0,62,62,0,1,0,1,0
59862,443,40236,443,5301,953,4348,17,28,9,8
29145,8168,0,0,62,62,0,1,0,1,0
49410,53,14771,53,167,86,81,2,30,1,1
36535,443,10367,443,416,210,206,7,27,4,3
53201,445,0,0,66,66,0,1,0,1,0
56169,53,17161,53,916,86,830,2,30,1,1
61784,445,0,0,70,70,0,1,0,1,0
64737,53,9334,53,269,110,159,2,30,1,1
52150,39109,0,0,66,66,0,1,0,1,0
58638,5900,0,0,62,62,0,1,0,1,0
2697,28189,0,0,60,60,0,1,0,1,0
55010,443,19028,443,7651,2261,5390,41,255,21,20
58692,445,0,0,70,70,0,1,0,1,0
50612,80,47441,80,1559,1107,452,9,24,5,4
43834,443,19453,443,4824,671,4153,13,29,7,6
50308,445,0,0,70,70,0,1,0,1,0
6881,6881,0,0,146,146,0,1,0,1,0
42745,50011,0,0,62,62,0,1,0,1,0
55541,53,64093,53,177,94,83,2,30,1,1
64941,53,17276,53,199,102,97,2,30,1,1
12318,36866,0,0,139,139,0,1,0,1,0
62394,80,62394,80,29401,10036,19365,49,28,24,25
56577,445,0,0,66,66,0,1,0,1,0
50677,445,0,0,66,66,0,1,0,1,0
57293,443,21825,443,5161,2421,2740,14,122,7,7
11692,25174,0,0,62,62,0,1,0,1,0
10004,57470,0,0,145,145,0,1,0,1,0
53774,58433,12540,58433,320,140,180,6,7,3,3
50523,53,46429,53,376,78,298,2,31,1,1
49168,57470,0,0,66,66,0,1,0,1,0
15005,32480,0,0,145,145,0,1,0,1,0
57322,443,7352,443,8237,2784,5453,35,16,21,14
38592,57209,0,0,62,62,0,1,0,1,0
57375,53,58111,53,247,102,145,2,30,1,1
64844,445,0,0,70,70,0,1,0,1,0
51684,445,0,0,70,70,0,1,0,1,0
64699,53,61689,53,338,110,228,2,30,1,1
52766,445,0,0,66,66,0,1,0,1,0
59790,445,0,0,70,70,0,1,0,1,0
59697,445,0,0,70,70,0,1,0,1,0
49380,53,50592,53,377,110,267,2,31,1,1
55338,445,0,0,70,70,0,1,0,1,0
56707,53,58987,53,199,94,105,2,30,1,1
56717,53,4326,53,183,94,89,2,29,1,1
53192,80,30945,80,814,335,479,10,15,5,5
50408,53,10616,53,183,94,89,2,30,1,1
993,51747,0,0,66,66,0,1,0,1,0
59254,443,5881,443,8332,1024,7308,21,25,11,10
38852,37965,0,0,62,62,0,1,0,1,0
57072,53,31261,53,816,102,714,2,29,1,1
63852,35440,0,0,66,66,0,1,0,1,0
54137,443,45668,443,10046,1394,8652,22,75,13,9
54179,443,27953,443,5037,2002,3035,14,120,7,7
56216,50584,0,0,62,62,0,1,0,1,0
61404,443,64202,443,4526,2655,1871,24,98,14,10
6881,30279,63096,30279,150,150,0,1,1200,1,0
35897,443,1439,443,6692,1642,5050,24,275,11,13
59868,443,9732,443,6869,3351,3518,22,135,11,11
54459,445,0,0,66,66,0,1,0,1,0
50633,445,0,0,70,70,0,1,0,1,0
56767,445,0,0,66,66,0,1,0,1,0
55311,53,15716,53,298,101,197,4,31,2,2
65077,445,0,0,70,70,0,1,0,1,0
60749,40010,57224,40010,316,136,180,6,5,3,3
44919,26467,0,0,62,62,0,1,0,1,0
50466,80,50466,80,78335,7114,71221,114,22,60,54
27005,27016,25142,27016,883,126,757,2,30,1,1
58486,57470,0,0,66,66,0,1,0,1,0
9849,53,9849,53,219,87,132,2,31,1,1
63146,445,0,0,66,66,0,1,0,1,0
51972,80,28549,80,7001170,112187,6888983,6101,29,1546,4555
27005,27272,38443,27272,887,126,761,2,30,1,1
61420,445,0,0,66,66,0,1,0,1,0
43151,443,30299,443,9462,4488,4974,28,96,13,15
64815,53,51366,53,214,110,104,2,30,1,1
65234,53,64779,53,186,95,91,2,31,1,1
53579,42707,0,0,66,66,0,1,0,1,0
56834,53,6671,53,178,94,84,2,31,1,1
53770,64147,0,0,66,66,0,1,0,1,0
45099,57470,0,0,62,62,0,1,0,1,0
43683,443,23640,443,6941,1551,5390,25,200,12,13
63832,25174,0,0,66,66,0,1,0,1,0
52848,445,0,0,70,70,0,1,0,1,0
50311,443,61436,443,466,392,74,4,0,3,1
9327,57470,0,0,62,62,0,1,0,1,0
56630,443,6016,443,7941,1952,5989,20,15,11,9
56556,445,0,0,70,70,0,1,0,1,0
60645,35440,0,0,66,66,0,1,0,1,0
56556,53,18816,53,184,94,90,2,31,1,1
62068,445,0,0,70,70,0,1,0,1,0
13484,37965,0,0,62,62,0,1,0,1,0
64713,445,0,0,70,70,0,1,0,1,0
55892,445,0,0,70,70,0,1,0,1,0
51993,55279,27826,55279,316,136,180,6,7,3,3
51129,80,6520,80,2794,2075,719,15,30,9,6
59166,443,40050,443,130458,7920,122538,199,359,94,105
443,35385,0,0,161,161,0,1,0,1,0
57788,445,0,0,70,70,0,1,0,1,0
53623,50093,42211,50093,552,306,246,9,38,5,4
51467,443,7148,443,20313,6637,13676,45,24,23,22
30651,53,22880,53,86,86,0,1,30,1,0
64755,443,45264,443,23561,3667,19894,40,121,19,21
55478,443,16411,443,23029908,732047,22297861,24550,183,8143,16407
57416,53,53787,53,193,102,91,2,30,1,1
36026,443,14720,443,7050,984,6066,18,39,12,6
50726,443,27589,443,12350,2504,9846,41,137,21,20
38873,443,28510,443,10209,2574,7635,39,917,18,21
49228,53,30182,53,193,102,91,2,30,1,1
55196,53,52555,53,711,87,624,2,30,1,1
54449,443,31656,443,128477,6347,122130,155,276,56,99
58182,443,50635,443,15327,8305,7022,49,137,24,25
53995,25174,0,0,66,66,0,1,0,1,0
50496,445,0,0,70,70,0,1,0,1,0
6889,60888,0,0,139,139,0,1,0,1,0
58747,443,20889,443,5167,700,4467,16,15,7,9
64991,53,4692,53,779,86,693,2,30,1,1
30114,65151,0,0,60,60,0,1,0,1,0
59478,445,0,0,70,70,0,1,0,1,0
52694,443,37161,443,10384,4563,5821,34,436,17,17
49914,53,39261,53,815,95,720,2,30,1,1
52870,445,0,0,66,66,0,1,0,1,0
1227,56205,0,0,66,66,0,1,0,1,0
56771,445,0,0,70,70,0,1,0,1,0
49597,80,42235,80,130,70,60,2,15,1,1
23383,64147,0,0,62,62,0,1,0,1,0
56682,445,0,0,70,70,0,1,0,1,0
55388,53,28391,53,177,94,83,2,30,1,1
57604,80,57604,80,16101,4026,12075,35,38,16,19
56632,443,5495,443,7941,1952,5989,20,15,11,9
51746,25174,0,0,62,62,0,1,0,1,0
43271,50584,0,0,62,62,0,1,0,1,0
55481,445,0,0,66,66,0,1,0,1,0
65477,53,61765,53,183,94,89,2,30,1,1
53143,50584,0,0,66,66,0,1,0,1,0
62544,445,0,0,66,66,0,1,0,1,0
52012,445,0,0,66,66,0,1,0,1,0
58638,5900,58638,5900,66,66,0,1,4,1,0
49236,80,22987,80,1904818,59945,1844873,1747,162,498,1249
61155,443,61155,443,4575,1668,2907,19,27,11,8
55440,53,50711,53,711,87,624,2,30,1,1
64985,53,34087,53,194,102,92,2,30,1,1
63175,445,0,0,70,70,0,1,0,1,0
33304,443,15471,443,1067,650,417,10,73,6,4
60193,53,20927,53,214,85,129,2,0,1,1
58328,445,0,0,70,70,0,1,0,1,0
49760,80,49760,80,613303,16858,596445,666,143,251,415
49492,53,11177,53,198,101,97,2,31,1,1
56606,3389,56606,3389,4130,2105,2025,18,16,9,9
64589,445,0,0,70,70,0,1,0,1,0
62014,35440,0,0,66,66,0,1,0,1,0
64420,53,18764,53,386,102,284,2,30,1,1
443,52504,0,0,97,97,0,1,0,1,0
56632,80,25180,80,234,234,0,4,12,4,0
5588,5588,0,0,3354,1792,1562,46,194,23,23
49759,53,16085,53,216,110,106,2,29,1,1
57162,445,0,0,70,70,0,1,0,1,0
35587,123,5043,123,184,94,90,2,30,1,1
59863,443,54710,443,12809,7765,5044,95,84,55,40
57570,443,58853,443,6226,4213,2013,30,79,18,12
50405,445,0,0,66,66,0,1,0,1,0
51982,443,54748,443,9010,2779,6231,30,361,15,15
54595,443,41142,443,5692,2502,3190,24,131,12,12
56663,445,0,0,70,70,0,1,0,1,0
45908,33330,0,0,60,60,0,1,0,1,0
55544,445,0,0,70,70,0,1,0,1,0
57676,64147,0,0,70,70,0,1,0,1,0
59583,445,0,0,70,70,0,1,0,1,0
51709,40705,43195,40705,70,70,0,2,8,2,0
65045,53,38314,53,339,105,234,4,53,2,2
58638,5900,0,0,62,62,0,1,0,1,0
49422,53,52820,53,719,208,511,6,32,3,3
64847,22114,0,0,66,66,0,1,0,1,0
57812,7635,57812,7635,138,78,60,3,6,2,1
63658,445,0,0,70,70,0,1,0,1,0
58374,445,0,0,70,70,0,1,0,1,0
54539,26467,0,0,62,62,0,1,0,1,0
62731,443,62731,443,9938,3644,6294,31,18,18,13
64326,53,26486,53,196,102,94,2,30,1,1
51812,1433,0,0,60,60,0,1,0,1,0
49662,53,17327,53,268,93,175,4,57,2,2
48448,48817,0,0,66,66,0,1,0,1,0
64146,53,50563,53,308,99,209,4,39,2,2
61448,443,1765,443,6109,1902,4207,33,141,19,14
59232,445,0,0,70,70,0,1,0,1,0
58638,5900,0,0,62,62,0,1,0,1,0
41267,8245,14045,8245,280,214,66,2,30,1,1
56707,445,0,0,70,70,0,1,0,1,0
40146,53,0,0,300,86,214,2,30,1,1
46906,25604,0,0,100,100,0,1,0,1,0
64314,53,49422,53,319,126,193,2,30,1,1
50052,65008,0,0,60,60,0,1,0,1,0
51393,445,0,0,66,66,0,1,0,1,0
54815,3389,54815,3389,3424,1710,1714,16,31,8,8
58638,5900,0,0,62,62,0,1,0,1,0
49448,53,48392,53,210,102,108,2,30,1,1
59966,37965,0,0,66,66,0,1,0,1,0
34301,21247,0,0,62,62,0,1,0,1,0
55626,63805,23725,63805,70,70,0,1,5,1,0
16944,50584,0,0,146,146,0,1,0,1,0
52217,36746,31872,36746,316,136,180,6,9,3,3
13970,42873,0,0,66,66,0,1,0,1,0
52219,445,0,0,66,66,0,1,0,1,0
63651,445,0,0,70,70,0,1,0,1,0
62864,445,0,0,70,70,0,1,0,1,0
64717,445,0,0,70,70,0,1,0,1,0
49307,53,61453,53,210,102,108,2,29,1,1
64940,36237,0,0,62,62,0,1,0,1,0
49365,445,0,0,70,70,0,1,0,1,0
55471,445,0,0,70,70,0,1,0,1,0
55577,80,44269,80,70,70,0,1,5,1,0
64996,53,37849,53,547,91,456,4,35,2,2
51164,64147,0,0,66,66,0,1,0,1,0
53806,443,60221,443,12788,2594,10194,40,17,20,20
62153,445,0,0,66,66,0,1,0,1,0
65055,445,0,0,70,70,0,1,0,1,0
4515,37807,0,0,146,146,0,1,0,1,0
56321,445,0,0,70,70,0,1,0,1,0
63079,64147,0,0,66,66,0,1,0,1,0
60634,445,0,0,66,66,0,1,0,1,0
56752,443,37907,443,8007,1987,6020,20,15,11,9
60354,443,37287,443,10223,3933,6290,49,115,22,27
53966,57470,0,0,62,62,0,1,0,1,0
51889,44348,63585,44348,70,70,0,2,8,2,0
51592,51505,0,0,66,66,0,1,0,1,0
56662,443,10328,443,318,192,126,6,15,4,2
26835,47993,0,0,62,62,0,1,0,1,0
53250,445,0,0,70,70,0,1,0,1,0
33664,80,55691,80,70,70,0,1,5,1,0
57866,53,0,0,216,80,136,2,30,1,1
54385,445,0,0,70,70,0,1,0,1,0
9460,80,52623,80,1641,483,1158,10,15,5,5
14084,43890,0,0,146,146,0,1,0,1,0
51963,21638,43079,21638,70,70,0,1,5,1,0
55126,53,7380,53,177,94,83,2,30,1,1
49895,443,39538,443,6060,1040,5020,20,34,11,9
62408,3478,35393,3478,3548,1868,1680,57,87,29,28
3986,17372,0,0,66,66,0,1,0,1,0
64169,53,8733,53,209,110,99,2,30,1,1
64980,53,1256,53,199,102,97,2,31,1,1
49615,80,42615,80,374,192,182,7,41,4,3
10011,40005,27073,40005,148,86,62,2,30,1,1
26699,35253,0,0,62,62,0,1,0,1,0
61230,445,0,0,70,70,0,1,0,1,0
63248,445,0,0,70,70,0,1,0,1,0
55752,8060,62936,8060,70,70,0,2,8,2,0
59449,445,0,0,70,70,0,1,0,1,0
52671,445,0,0,66,66,0,1,0,1,0
61910,445,0,0,66,66,0,1,0,1,0
27761,53,27761,53,832,106,726,2,30,1,1
53546,17203,56777,17203,320,140,180,6,7,3,3
50391,80,6997,80,300,180,120,6,26,4,2
60347,80,6401,80,2018,1704,314,16,15,11,5
64000,445,0,0,70,70,0,1,0,1,0
52007,443,2667,443,10217,8266,1951,33,39,20,13
50817,445,0,0,70,70,0,1,0,1,0
2704,37,0,0,60,60,0,1,0,1,0
50628,80,46976,80,1658,1247,411,8,14,5,3
14397,37965,0,0,62,62,0,1,0,1,0
49935,53,45170,53,168,86,82,2,30,1,1
55796,53,34450,53,214,94,120,2,30,1,1
61927,445,0,0,70,70,0,1,0,1,0
57131,7774,0,0,145,145,0,1,0,1,0
9129,53,56648,53,205,86,119,2,30,1,1
55711,26467,0,0,66,66,0,1,0,1,0
58627,25174,0,0,62,62,0,1,0,1,0
40834,50584,0,0,146,146,0,1,0,1,0
60401,30046,28995,30046,70,70,0,2,8,2,0
53827,443,32061,443,499,425,74,4,0,3,1
56050,53,26569,53,178,94,84,2,30,1,1
55249,443,62038,443,3056958,73055,2983903,3016,43,1023,1993
52245,443,44464,443,7488,2474,5014,23,3600,12,11
60571,26467,0,0,62,62,0,1,0,1,0
49616,30188,0,0,66,66,0,1,0,1,0
56656,445,0,0,70,70,0,1,0,1,0
50661,80,9944,80,2693,461,2232,14,17,6,8
60761,445,0,0,70,70,0,1,0,1,0
6014,37965,0,0,66,66,0,1,0,1,0
33931,50584,0,0,62,62,0,1,0,1,0
62485,445,0,0,66,66,0,1,0,1,0
993,4543,0,0,66,66,0,1,0,1,0
57453,445,0,0,70,70,0,1,0,1,0
61265,445,0,0,70,70,0,1,0,1,0
51270,443,53083,443,190,70,120,4,15,2,2
50526,80,52180,80,259593,12828,246765,308,156,118,190
57389,445,0,0,70,70,0,1,0,1,0
58043,80,57225,80,378,192,186,7,20,4,3
49332,53,39051,53,740,93,647,2,31,1,1
37851,443,37851,443,4691,1784,2907,19,27,11,8
52311,445,0,0,70,70,0,1,0,1,0
51407,443,24262,443,22626,10213,12413,35,57,20,15
63755,445,0,0,66,66,0,1,0,1,0
51144,445,0,0,66,66,0,1,0,1,0
58792,443,15545,443,9278,6126,3152,27,16,15,12
62620,445,0,0,70,70,0,1,0,1,0
49889,443,5001,443,214782,13389,201393,277,50,98,179
51463,445,0,0,70,70,0,1,0,1,0
35657,48637,0,0,145,145,0,1,0,1,0
52175,1101,39473,1101,70,70,0,2,8,2,0
6881,8999,10252,8999,502,150,352,2,1199,1,1
50814,53,0,0,82,82,0,1,30,1,0
43862,443,61828,443,6600,1174,5426,23,62,13,10
63960,53,41492,53,172,88,84,2,31,1,1
58168,445,0,0,70,70,0,1,0,1,0
0,0,0,0,156,156,0,2,0,2,0
64723,53,29424,53,165,86,79,2,31,1,1
50972,3544,45034,3544,258,107,151,2,31,1,1
53759,443,57982,443,499,425,74,4,0,3,1
57884,443,2033,443,3981,1811,2170,26,177,14,12
54902,80,36045,80,1107,630,477,10,16,6,4
32811,443,18226,443,16652,13777,2875,48,44,27,21
36829,443,57108,443,560,280,280,9,27,5,4
50482,445,0,0,70,70,0,1,0,1,0
64016,445,0,0,66,66,0,1,0,1,0
52662,445,0,0,70,70,0,1,0,1,0
52918,445,0,0,70,70,0,1,0,1,0
52155,445,0,0,70,70,0,1,0,1,0
60186,53,47856,53,199,94,105,2,30,1,1
50898,80,8835,80,21445,1605,19840,36,255,19,17
33923,443,55200,443,4472,1666,2806,13,121,6,7
55567,53,55567,53,216,90,126,2,30,1,1
26467,6969,47386,6969,192,192,0,4,1200,4,0
56275,53,46209,53,166,86,80,2,30,1,1
64670,53,9827,53,183,86,97,2,30,1,1
53266,443,13911,443,12822,4426,8396,42,18,24,18
54787,443,54787,443,18160,6539,11621,37,19,22,15
59523,37965,0,0,62,62,0,1,0,1,0
49219,53,24039,53,264,102,162,2,30,1,1
9464,443,61543,443,9340,5582,3758,36,38,21,15
49590,57470,0,0,78,78,0,1,0,1,0
61205,445,0,0,70,70,0,1,0,1,0
56474,445,0,0,70,70,0,1,0,1,0
41575,443,49577,443,24256,1841,22415,41,131,18,23
35338,443,9775,443,7504,2762,4742,35,61,17,18
52149,80,41444,80,1638,1324,314,10,15,5,5
64841,53,21377,53,173,94,79,2,30,1,1
39119,44847,0,0,62,62,0,1,0,1,0
54716,445,0,0,66,66,0,1,0,1,0
49839,53,59644,53,258,110,148,2,29,1,1
31021,35440,0,0,146,146,0,1,0,1,0
56767,443,38617,443,7941,1952,5989,20,15,11,9
50405,443,58184,443,612,280,332,10,26,5,5
64741,53,19831,53,420,110,310,2,30,1,1
63305,62413,0,0,62,62,0,1,0,1,0
47700,51505,0,0,66,66,0,1,0,1,0
49213,53,44755,53,211,102,109,2,30,1,1
54249,443,37595,443,499,425,74,4,0,3,1
65451,53,6208,53,188,96,92,2,31,1,1
37565,443,47595,443,8553,3392,5161,25,202,13,12
64072,80,14418,80,314,192,122,6,15,4,2
64173,445,0,0,70,70,0,1,0,1,0
58887,15000,7750,15000,138,78,60,2,6,1,1
51646,80,56559,80,378,192,186,7,38,4,3
50744,443,22315,443,6854,1380,5474,18,161,9,9
50587,443,51277,443,1198,716,482,12,98,7,5
60700,445,0,0,70,70,0,1,0,1,0
56283,53,17978,53,315,102,213,2,30,1,1
38413,53,37201,53,199,94,105,2,29,1,1
17289,25174,0,0,146,146,0,1,0,1,0
3052,7302,0,0,66,66,0,1,0,1,0
57097,445,0,0,70,70,0,1,0,1,0
50579,53,55360,53,174,89,85,2,31,1,1
63319,53,8378,53,315,102,213,2,31,1,1
60521,445,0,0,66,66,0,1,0,1,0
59068,49813,0,0,74,74,0,1,0,1,0
55336,53,7329,53,199,102,97,2,30,1,1
56143,53,42893,53,195,94,101,2,30,1,1
55721,445,0,0,70,70,0,1,0,1,0
50095,445,0,0,70,70,0,1,0,1,0
53137,35111,13746,35111,70,70,0,2,8,2,0
27988,40002,6353,40002,140,78,62,2,30,1,1
48144,21247,0,0,66,66,0,1,0,1,0
49418,27015,65524,27015,287,78,209,2,30,1,1
49001,40108,0,0,161,161,0,1,0,1,0
6980,48543,0,0,139,139,0,1,0,1,0
27337,51505,0,0,62,62,0,1,0,1,0
37630,443,19874,443,10000,2634,7366,28,46,16,12
55259,443,24007,443,4523,3044,1479,17,64,10,7
51927,445,0,0,70,70,0,1,0,1,0
56519,53,28431,53,167,86,81,2,30,1,1
45717,80,45717,80,2081,1632,449,10,19,6,4
55659,37787,47813,37787,70,70,0,2,8,2,0
26324,30188,0,0,62,62,0,1,0,1,0
59713,3389,59713,3389,4213,2429,1784,18,32,9,9
45682,1,0,0,62,62,0,1,0,1,0
39600,5900,0,0,60,60,0,1,0,1,0
49486,443,60567,443,4160,1015,3145,16,28,8,8
50803,445,0,0,66,66,0,1,0,1,0
64730,445,0,0,66,66,0,1,0,1,0
56272,445,0,0,70,70,0,1,0,1,0
61691,445,0,0,70,70,0,1,0,1,0
53131,44021,31517,44021,698,320,378,10,16,6,4
52531,445,0,0,70,70,0,1,0,1,0
54489,443,33538,443,4263,2019,2244,14,136,7,7
55732,53,41995,53,177,94,83,2,29,1,1
51733,30688,11073,30688,70,70,0,1,4,1,0
16057,51050,0,0,66,66,0,1,0,1,0
59386,445,0,0,66,66,0,1,0,1,0
43666,443,10694,443,13212,9431,3781,41,238,21,20
46280,5900,0,0,60,60,0,1,0,1,0
50280,57470,0,0,78,78,0,1,0,1,0
40214,443,5611,443,3910,2223,1687,24,3676,8,16
50479,445,0,0,66,66,0,1,0,1,0
58636,445,0,0,70,70,0,1,0,1,0
50365,443,19679,443,712,374,338,11,28,6,5
443,4205,0,0,187,187,0,1,0,1,0
63488,445,0,0,66,66,0,1,0,1,0
52107,11191,13712,11191,70,70,0,2,7,2,0
42202,443,2028,443,6610,1106,5504,23,361,12,11
64360,445,0,0,70,70,0,1,0,1,0
60571,443,5687,443,8728,4031,4697,23,17,12,11
31845,55777,0,0,62,62,0,1,0,1,0
63554,44847,0,0,66,66,0,1,0,1,0
49628,53,6846,53,168,86,82,2,31,1,1
52492,37965,0,0,66,66,0,1,0,1,0
60241,80,52293,80,29924,6743,23181,37,150,16,21
53695,21965,20178,21965,2044,1143,901,19,16,9,10
57009,53,27487,53,1435,98,1337,4,34,2,2
45410,1,0,0,62,62,0,1,0,1,0
52052,80,64577,80,2188,593,1595,11,16,5,6
64627,53,17603,53,198,101,97,2,30,1,1
54962,53,60392,53,194,102,92,2,29,1,1
52472,51221,0,0,74,74,0,1,0,1,0
58145,445,0,0,70,70,0,1,0,1,0
48135,443,38274,443,6426,1858,4568,22,16,12,10
5688,44847,0,0,62,62,0,1,0,1,0
57783,445,0,0,70,70,0,1,0,1,0
56732,445,0,0,70,70,0,1,0,1,0
64966,53,51667,53,458,188,270,6,31,3,3
61059,445,0,0,70,70,0,1,0,1,0
50556,445,0,0,70,70,0,1,0,1,0
64414,53,3637,53,193,102,91,2,30,1,1
53628,445,0,0,66,66,0,1,0,1,0
64420,445,0,0,66,66,0,1,0,1,0
50980,443,12783,443,3964,1908,2056,23,94,13,10
38728,53,38728,53,414,268,146,3,33,2,1
49736,443,37577,443,378,192,186,7,15,4,3
59875,443,3172,443,12357,5182,7175,30,108,13,17
39145,443,40241,443,4602,1305,3297,27,183,12,15
65112,53,1739,53,209,110,99,2,31,1,1
60453,24369,18318,24369,70,70,0,1,5,1,0
63446,445,0,0,70,70,0,1,0,1,0
56381,51505,0,0,62,62,0,1,0,1,0
52005,33191,35955,33191,70,70,0,1,5,1,0
45908,33330,0,0,60,60,0,1,0,1,0
65520,443,22541,443,438102,12780,425322,449,15,157,292
56474,53,9698,53,209,110,99,2,29,1,1
55347,443,1685,443,116686,21822,94864,224,186,112,112
60276,445,0,0,70,70,0,1,0,1,0
25565,38308,0,0,60,60,0,1,0,1,0
27005,1104,16545,1104,870,126,744,2,30,1,1
65269,445,0,0,70,70,0,1,0,1,0
1356,57470,0,0,72,72,0,1,0,1,0
63045,443,61231,443,510,164,346,2,30,1,1
64113,22211,60375,22211,312,132,180,6,7,3,3
39328,80,54036,80,78,78,0,1,5,1,0
58194,443,27436,443,3108,1047,2061,14,136,7,7
58054,25,23956,25,1370,496,874,16,16,8,8
49135,443,9255,443,2529,1230,1299,17,16,9,8
50432,80,29144,80,318,192,126,6,27,4,2
52213,445,0,0,66,66,0,1,0,1,0
64963,27037,16564,27037,741,462,279,2,31,1,1
64663,53,18610,53,578,286,292,9,15,5,4
45964,2228,0,0,60,60,0,1,0,1,0
49985,53,61904,53,312,90,222,2,31,1,1
44467,53,44467,53,211,80,131,2,30,1,1
20850,53,20850,53,245,98,147,2,30,1,1
50264,443,26394,443,25435,5293,20142,104,138,54,50
27005,30006,22484,30006,890,126,764,2,31,1,1
49557,53,61895,53,1298,100,1198,4,32,2,2
5588,5588,0,0,3498,1872,1626,48,195,24,24
36262,53,36262,53,216,90,126,2,30,1,1
61898,445,0,0,66,66,0,1,0,1,0
50459,53,40007,53,811,94,717,2,30,1,1
56322,53,21211,53,166,86,80,2,29,1,1
58638,5900,0,0,62,62,0,1,0,1,0
32007,1212,0,0,145,145,0,1,0,1,0
65463,445,0,0,66,66,0,1,0,1,0
3090,1,0,0,66,66,0,1,0,1,0
57406,53,49515,53,194,102,92,2,30,1,1
52734,445,0,0,70,70,0,1,0,1,0
55717,13517,61965,13517,70,70,0,2,8,2,0
9162,443,30671,443,5658,501,5157,14,15,7,7
64489,445,0,0,70,70,0,1,0,1,0
56853,443,46609,443,7092,1795,5297,25,32,14,11
59549,445,0,0,70,70,0,1,0,1,0
51765,52862,26786,52862,70,70,0,2,7,2,0
46624,80,46624,80,34504,2526,31978,45,156,16,29
49744,80,36258,80,2455,475,1980,9,81,5,4
52152,58114,40189,58114,70,70,0,2,8,2,0
60936,443,44472,443,4621,3079,1542,24,52,13,11
56748,53,15879,53,184,94,90,2,30,1,1
49348,443,47501,443,2879984,113967,2766017,3396,129,1423,1973
52296,445,0,0,66,66,0,1,0,1,0
55550,445,0,0,66,66,0,1,0,1,0
58352,445,0,0,70,70,0,1,0,1,0
49575,53,59647,53,244,102,142,2,29,1,1
61438,443,9604,443,4933,771,4162,18,28,8,10
50637,36237,0,0,66,66,0,1,0,1,0
3792,52700,0,0,62,62,0,1,0,1,0
63919,445,0,0,70,70,0,1,0,1,0
58830,443,23946,443,5168,700,4468,16,15,7,9
33122,80,28324,80,9055,863,8192,18,45,10,8
62386,37965,0,0,66,66,0,1,0,1,0
63967,53,11149,53,195,102,93,2,30,1,1
50988,443,14910,443,6938,2686,4252,25,27,12,13
58576,445,0,0,70,70,0,1,0,1,0
14199,443,14199,443,416,198,218,7,27,4,3
5380,53,15988,53,377,94,283,2,30,1,1
50122,443,28442,443,130,70,60,2,15,1,1
58927,443,34485,443,5168,700,4468,16,15,7,9
64857,53,57218,53,332,104,228,2,30,1,1
53853,443,38658,443,499,425,74,4,0,3,1
56794,46824,0,0,66,66,0,1,0,1,0
6943,14984,0,0,100,100,0,1,0,1,0
52969,44847,0,0,66,66,0,1,0,1,0
33671,443,8770,443,12536,1564,10972,30,809,13,17
56459,53,20811,53,209,110,99,2,30,1,1
55370,445,0,0,70,70,0,1,0,1,0
51163,445,0,0,70,70,0,1,0,1,0
53324,44847,0,0,66,66,0,1,0,1,0
50605,445,0,0,70,70,0,1,0,1,0
55224,53,33137,53,209,110,99,2,30,1,1
59101,53,46129,53,195,94,101,2,30,1,1
56668,53,43075,53,199,102,97,2,30,1,1
51062,1433,0,0,60,60,0,1,0,1,0
63751,17102,12860,17102,312,132,180,6,6,3,3
49861,53,46345,53,261,94,167,2,30,1,1
58715,57470,0,0,66,66,0,1,0,1,0
38330,123,58815,123,184,94,90,2,30,1,1
35626,22114,0,0,66,66,0,1,0,1,0
57073,57470,0,0,62,62,0,1,0,1,0
58862,445,0,0,70,70,0,1,0,1,0
58638,5900,0,0,62,62,0,1,0,1,0
61408,80,60964,80,420720,29056,391664,771,159,325,446
58434,443,57588,443,170342,10231,160111,264,136,130,134
59957,25,59957,25,1721,681,1040,22,17,10,12
6882,5406,43769,5406,654,150,504,3,1200,1,2
35405,53,35405,53,217,87,130,2,30,1,1
51989,80,41304,80,4166,1708,2458,14,16,7,7
50976,80,37762,80,3030,1372,1658,13,21,8,5
3399,25174,0,0,66,66,0,1,0,1,0
54692,445,0,0,70,70,0,1,0,1,0
49781,53,21515,53,194,102,92,2,30,1,1
59468,445,0,0,70,70,0,1,0,1,0
52607,445,0,0,70,70,0,1,0,1,0
60058,25174,0,0,66,66,0,1,0,1,0
62972,445,0,0,70,70,0,1,0,1,0
61970,57866,0,0,62,62,0,1,0,1,0
51900,48817,0,0,146,146,0,1,0,1,0
49217,53,30696,53,282,93,189,4,45,2,2
58638,5900,0,0,62,62,0,1,0,1,0
49328,443,48321,443,77821,4380,73441,82,53,23,59
55286,53,22881,53,268,87,181,4,35,2,2
65406,53,43109,53,273,102,171,2,30,1,1
6881,6889,64062,6889,228,118,110,2,1199,1,1
50907,445,0,0,70,70,0,1,0,1,0
50265,59362,35253,59362,4228,2471,1757,55,2758,31,24
49690,53,31414,53,216,110,106,2,30,1,1
35699,443,53038,443,2060,1106,954,17,150,10,7
56417,445,0,0,70,70,0,1,0,1,0
59343,53,0,0,178,72,106,2,29,1,1
46965,53,4424,53,199,94,105,2,30,1,1
53968,17904,18186,17904,320,140,180,6,7,3,3
58638,5900,0,0,62,62,0,1,0,1,0
59960,445,0,0,70,70,0,1,0,1,0
33197,443,9055,443,1067,650,417,10,27,6,4
19632,37965,0,0,62,62,0,1,0,1,0
60424,445,0,0,70,70,0,1,0,1,0
65491,53,7417,53,193,102,91,2,30,1,1
443,14591,0,0,131,131,0,1,0,1,0
59017,445,0,0,70,70,0,1,0,1,0
50584,53,13408,53,793,101,692,2,30,1,1
65528,53,30567,53,168,86,82,2,31,1,1
62632,35440,0,0,66,66,0,1,0,1,0
57592,443,17732,443,2614,1689,925,18,19,10,8
58889,443,61172,443,3956,2519,1437,18,80,10,8
50590,53,53774,53,889,404,485,10,30,5,5
51653,445,0,0,66,66,0,1,0,1,0
54322,443,16940,443,14649,11393,3256,49,99,22,27
57577,443,27380,443,39421,4980,34441,57,144,23,34
50086,57470,0,0,66,66,0,1,0,1,0
47054,443,53511,443,6803,2164,4639,14,121,7,7
37087,80,29544,80,946,531,415,11,296,6,5
11876,22,0,0,60,60,0,1,0,1,0
54383,445,0,0,70,70,0,1,0,1,0
51525,445,0,0,70,70,0,1,0,1,0
50560,443,29461,443,408090,25873,382217,748,137,354,394
57761,445,0,0,70,70,0,1,0,1,0
56715,445,0,0,70,70,0,1,0,1,0
62067,80,14393,80,1862,616,1246,11,15,6,5
55605,53,12415,53,300,88,212,4,51,2,2
55821,445,0,0,70,70,0,1,0,1,0
48230,22114,0,0,146,146,0,1,0,1,0
14659,11392,0,0,146,146,0,1,0,1,0
1024,57470,0,0,62,62,0,1,0,1,0
63064,443,8160,443,448,166,282,2,30,1,1
64914,53,27750,53,168,86,82,2,30,1,1
60215,80,6497,80,21073,15881,5192,47,151,30,17
65208,53,46888,53,637,178,459,6,70,3,3
64959,53,35711,53,173,94,79,2,30,1,1
49808,445,0,0,70,70,0,1,0,1,0
58301,445,0,0,66,66,0,1,0,1,0
62760,445,0,0,66,66,0,1,0,1,0
53783,443,19626,443,499,425,74,4,0,3,1
62396,51050,0,0,146,146,0,1,0,1,0
60508,445,0,0,70,70,0,1,0,1,0
2777,23,2777,23,130,66,64,2,4,1,1
51425,37450,0,0,62,62,0,1,0,1,0
34432,80,52921,80,6260,696,5564,17,16,9,8
56720,53,7909,53,177,94,83,2,30,1,1
42298,40038,63975,40038,148,86,62,2,30,1,1
33497,53,21271,53,168,78,90,2,30,1,1
49754,53,60786,53,180,94,86,2,30,1,1
54707,443,60614,443,5826,1199,4627,21,42,11,10
32742,53,46400,53,207,86,121,2,30,1,1
56553,445,0,0,70,70,0,1,0,1,0
63069,445,0,0,70,70,0,1,0,1,0
64162,53,51950,53,255,118,137,2,29,1,1
64686,53,28216,53,811,94,717,2,30,1,1
58858,15503,0,0,66,66,0,1,0,1,0
53799,445,0,0,70,70,0,1,0,1,0
63213,35440,0,0,62,62,0,1,0,1,0
40819,30975,0,0,157,157,0,1,0,1,0
47996,80,47996,80,1920,1471,449,10,19,6,4
41891,443,2286,443,235626,4546,231080,232,339,53,179
33849,53,34954,53,336,231,105,3,30,2,1
56239,445,0,0,70,70,0,1,0,1,0
49868,445,0,0,70,70,0,1,0,1,0
56555,53,42493,53,348,94,254,2,30,1,1
56756,53,14084,53,167,86,81,2,30,1,1
56424,53,11596,53,170,87,83,2,31,1,1
34920,53,40562,53,168,78,90,2,31,1,1
45964,3111,0,0,60,60,0,1,0,1,0
60892,445,0,0,70,70,0,1,0,1,0
40970,80,47105,80,1052,612,440,10,15,5,5
56464,53,12026,53,177,94,83,2,30,1,1
33556,25174,0,0,146,146,0,1,0,1,0
65133,53,56873,53,196,100,96,2,31,1,1
27005,27019,17502,27019,873,126,747,2,30,1,1
59581,53,59581,53,823,98,725,2,29,1,1
56987,53,21347,53,196,102,94,2,30,1,1
53115,445,0,0,66,66,0,1,0,1,0
58226,52848,0,0,62,62,0,1,0,1,0
5790,43890,0,0,62,62,0,1,0,1,0
57331,53,57928,53,178,94,84,2,29,1,1
1865,25174,0,0,146,146,0,1,0,1,0
54077,445,0,0,70,70,0,1,0,1,0
58638,5900,0,0,62,62,0,1,0,1,0
59996,443,60855,443,1641,730,911,14,18,8,6
61445,443,34767,443,97211,3043,94168,109,121,37,72
27005,1202,59034,1202,865,126,739,2,30,1,1
59467,445,0,0,66,66,0,1,0,1,0
60078,80,2527,80,1114,534,580,12,15,7,5
14924,44847,0,0,62,62,0,1,0,1,0
52133,15015,56839,15015,70,70,0,2,8,2,0
56004,53,53891,53,177,94,83,2,30,1,1
54993,53,49299,53,410,109,301,4,32,2,2
58638,5900,0,0,62,62,0,1,0,1,0
443,64347,0,0,131,131,0,1,0,1,0
64151,445,0,0,70,70,0,1,0,1,0
27988,40006,7041,40006,148,86,62,2,30,1,1
50996,445,0,0,66,66,0,1,0,1,0
51324,11392,0,0,66,66,0,1,0,1,0
63235,443,19696,443,1373,734,639,17,96,10,7
60613,443,54092,443,154465,11473,142992,244,212,101,143
8430,53,21349,53,80361,77433,2928,946,89,930,16
44943,443,56912,443,16225,2078,14147,38,42,19,19
53883,445,0,0,66,66,0,1,0,1,0
57307,53,14179,53,177,94,83,2,30,1,1
9177,443,23456,443,6331,837,5494,19,28,10,9
56106,53,18399,53,193,102,91,2,30,1,1
60579,25174,0,0,66,66,0,1,0,1,0
61246,445,0,0,66,66,0,1,0,1,0
55168,445,0,0,70,70,0,1,0,1,0
48478,49903,0,0,62,62,0,1,0,1,0
64722,53,7575,53,184,94,90,2,30,1,1
58524,445,0,0,70,70,0,1,0,1,0
56811,443,16024,443,8020,2000,6020,20,15,11,9
49742,53,9539,53,213,102,111,2,29,1,1
58867,445,0,0,66,66,0,1,0,1,0
60936,443,12668,443,1864,250,1614,8,120,4,4
10639,11392,0,0,62,62,0,1,0,1,0
22350,25174,0,0,66,66,0,1,0,1,0
9471,443,58396,443,8533,1544,6989,22,30,11,11
50544,443,14371,443,11083,4570,6513,24,35,13,11
46297,80,56497,80,1155,781,374,10,15,6,4
56941,53,4680,53,192,98,94,2,31,1,1
57774,445,0,0,70,70,0,1,0,1,0
49867,53,63133,53,177,94,83,2,30,1,1
64899,53,12836,53,199,102,97,2,29,1,1
57470,39608,19893,39608,330,330,0,6,1199,6,0
63347,25174,0,0,62,62,0,1,0,1,0
37603,443,12094,443,8493,2314,6179,33,15,18,15
49009,53,49009,53,172,76,96,2,30,1,1
55246,443,12271,443,6144,1810,4334,18,45,11,7
64668,53,24152,53,211,102,109,2,30,1,1
51341,445,0,0,70,70,0,1,0,1,0
58848,443,16146,443,2109,420,1689,11,121,6,5
40599,443,12842,443,89724,81316,8408,148,404,69,79
57076,53,47154,53,184,94,90,2,30,1,1
53752,445,0,0,66,66,0,1,0,1,0
56754,53,1275,53,751,95,656,2,30,1,1
51654,80,36290,80,170875,6864,164011,255,35,93,162
27889,32480,0,0,100,100,0,1,0,1,0
52409,443,39608,443,1369,708,661,14,24,8,6
38711,443,23557,443,459089,10521,448568,449,16,141,308
10390,26467,0,0,66,66,0,1,0,1,0
60888,445,0,0,70,70,0,1,0,1,0
27005,27017,47971,27017,1616,126,1490,4,30,2,2
57070,443,3388,443,18227,6731,11496,63,18,34,29
57470,47004,40280,47004,152,152,0,2,1200,2,0
50365,80,49822,80,300,180,120,6,29,4,2
50674,445,0,0,70,70,0,1,0,1,0
58638,5900,0,0,62,62,0,1,0,1,0
50637,44847,0,0,66,66,0,1,0,1,0
64068,53,56393,53,168,86,82,2,31,1,1
56169,53,42323,53,204,104,100,2,30,1,1
55353,53,65240,53,168,86,82,2,30,1,1
61353,443,57410,443,4401,1654,2747,10,120,5,5
49531,80,57829,80,78,78,0,1,5,1,0
56777,42486,21252,42486,70,70,0,1,5,1,0
58741,445,0,0,70,70,0,1,0,1,0
56819,37372,7815,37372,70,70,0,1,5,1,0
55271,445,0,0,66,66,0,1,0,1,0
54598,37965,0,0,66,66,0,1,0,1,0
56830,53,25316,53,195,102,93,2,29,1,1
64878,26467,0,0,62,62,0,1,0,1,0
50827,443,49837,443,7298,2661,4637,21,17,11,10
49543,53,11834,53,779,110,669,2,30,1,1
65250,53,37683,53,353,98,255,4,32,2,2
52007,445,0,0,70,70,0,1,0,1,0
58762,445,0,0,70,70,0,1,0,1,0
25961,55783,0,0,66,66,0,1,0,1,0
55179,53,32980,53,183,94,89,2,30,1,1
54539,26467,0,0,62,62,0,1,0,1,0
53890,23310,52916,23310,70,70,0,2,8,2,0
55019,53,27465,53,299,110,189,4,31,2,2
56491,53,20777,53,165,86,79,2,31,1,1
51833,47388,26582,47388,70,70,0,2,6,2,0
39924,443,50465,443,5229,1002,4227,21,16,11,10
26978,443,38800,443,7547,2728,4819,26,20,13,13
55797,53,58319,53,170,87,83,2,31,1,1
60769,443,3938,443,7639,2051,5588,33,120,17,16
56941,53,44223,53,196,102,94,2,30,1,1
55368,443,50740,443,8551,2955,5596,28,423,15,13
57196,445,0,0,70,70,0,1,0,1,0
60435,35440,0,0,62,62,0,1,0,1,0
1024,25174,0,0,146,146,0,1,0,1,0
65040,53,11010,53,178,94,84,2,29,1,1
58022,8112,0,0,60,60,0,1,0,1,0
64403,53,60359,53,198,101,97,2,30,1,1
52370,445,0,0,66,66,0,1,0,1,0
53626,30317,0,0,66,66,0,1,0,1,0
28025,443,15107,443,5578,1390,4188,19,15,9,10
55640,445,0,0,70,70,0,1,0,1,0
57089,53,22992,53,239,94,145,2,29,1,1
65519,443,19659,443,436359,12780,423579,448,16,157,291
36710,443,45580,443,6786,1795,4991,18,16,11,7
53990,445,0,0,66,66,0,1,0,1,0
51863,22038,18854,22038,70,70,0,2,7,2,0
56433,53,26629,53,177,94,83,2,30,1,1
49260,53,27595,53,177,86,91,2,29,1,1
52921,443,44773,443,36892,20283,16609,191,116,77,114
50326,46824,0,0,66,66,0,1,0,1,0
56793,53,12485,53,196,102,94,2,30,1,1
63763,17368,8449,17368,66,66,0,1,5,1,0
52024,47600,56931,47600,70,70,0,2,8,2,0
52682,22114,0,0,66,66,0,1,0,1,0
28557,53,28557,53,213,79,134,2,32,1,1
65507,443,3045,443,453047,13340,439707,469,16,165,304
35702,443,5840,443,6751,1889,4862,24,316,13,11
19610,9571,0,0,62,62,0,1,0,1,0
12573,53,12573,53,235,90,145,2,32,1,1
56421,53,57015,53,177,94,83,2,30,1,1
32282,8604,0,0,62,62,0,1,0,1,0
50584,60395,46252,60395,166,166,0,1,1200,1,0
49661,445,0,0,70,70,0,1,0,1,0
57470,31114,57905,31114,528,528,0,9,1199,9,0
37594,443,15585,443,60339,4689,55650,79,47,35,44
55417,53,62498,53,198,102,96,2,32,1,1
49835,53,19938,53,194,102,92,2,30,1,1
51427,80,51427,80,22364,4125,18239,41,26,19,22
27348,80,31901,80,1550,850,700,10,18,5,5
62861,443,20935,443,4777,2262,2515,10,122,5,5
46477,443,29699,443,4900,904,3996,16,97,9,7
49837,443,60962,443,9634,2232,7402,24,123,12,12
53522,24116,32649,24116,70,70,0,2,8,2,0
60460,54233,13899,54233,70,70,0,1,5,1,0
62956,445,0,0,70,70,0,1,0,1,0
64406,50584,0,0,62,62,0,1,0,1,0
32968,43890,0,0,146,146,0,1,0,1,0
62728,445,0,0,66,66,0,1,0,1,0
54960,443,1507,443,17670,2044,15626,53,316,21,32
64168,53,53054,53,306,94,212,2,30,1,1
62409,445,0,0,66,66,0,1,0,1,0
49545,443,43829,443,6606,936,5670,17,23,9,8
62820,53,62820,53,237,91,146,2,33,1,1
58638,5900,0,0,62,62,0,1,0,1,0
52030,43068,29971,43068,66,66,0,1,5,1,0
56726,443,54514,443,4221,666,3555,13,15,7,6
61693,443,50704,443,12203,3519,8684,65,18,35,30
27988,40017,42811,40017,148,86,62,2,30,1,1
58702,445,0,0,66,66,0,1,0,1,0
61535,445,0,0,66,66,0,1,0,1,0
57817,445,0,0,70,70,0,1,0,1,0
53495,37807,0,0,66,66,0,1,0,1,0
63945,53,11861,53,216,110,106,2,31,1,1
52781,57470,0,0,66,66,0,1,0,1,0
12632,25174,0,0,62,62,0,1,0,1,0
5664,36237,0,0,66,66,0,1,0,1,0
64017,53,10978,53,461,94,367,2,29,1,1
65399,53,0,0,191,75,116,2,30,1,1
64730,445,0,0,70,70,0,1,0,1,0
50151,53,24855,53,177,94,83,2,30,1,1
50969,443,44036,443,7221,2265,4956,16,127,7,9
14446,443,21708,443,2616,1470,1146,18,16,8,10
63925,445,0,0,70,70,0,1,0,1,0
61078,123,41282,123,184,94,90,2,30,1,1
56679,5900,0,0,60,60,0,1,0,1,0
60953,443,32015,443,103580,4856,98724,133,17,56,77
55127,53,49558,53,253,87,166,4,44,2,2
55667,53,30119,53,305,126,179,2,30,1,1
51164,445,0,0,66,66,0,1,0,1,0
51073,443,51073,443,1210,637,573,14,25,7,7
49192,80,39568,80,2807,587,2220,13,16,7,6
65318,445,0,0,70,70,0,1,0,1,0
12230,53,12230,53,216,90,126,2,29,1,1
18650,23718,0,0,62,62,0,1,0,1,0
64602,53,49677,53,184,94,90,2,30,1,1
57000,53,24193,53,194,102,92,2,30,1,1
49627,53,57352,53,288,110,178,2,31,1,1
57186,53,41154,53,177,94,83,2,30,1,1
42298,40002,3434,40002,241,178,63,2,31,1,1
27402,37628,0,0,62,62,0,1,0,1,0
55321,53,63193,53,193,102,91,2,30,1,1
60425,15503,0,0,145,145,0,1,0,1,0
37965,16881,45844,16881,448,246,202,4,1199,2,2
58683,445,0,0,70,70,0,1,0,1,0
53778,6881,15801,6881,70,70,0,1,5,1,0
52683,22114,0,0,62,62,0,1,0,1,0
49576,80,3769,80,318,192,126,6,43,4,2
58839,443,29041,443,6270,4231,2039,22,16,11,11
50363,53,11154,53,214,110,104,2,30,1,1
13285,29892,0,0,145,145,0,1,0,1,0
60913,445,0,0,70,70,0,1,0,1,0
53792,53,47522,53,224,86,138,2,30,1,1
50655,445,0,0,70,70,0,1,0,1,0
56142,53,42662,53,194,102,92,2,31,1,1
12605,57470,0,0,62,62,0,1,0,1,0
54654,6881,17557,6881,470,348,122,6,26,4,2
53166,445,0,0,70,70,0,1,0,1,0
56127,53,8590,53,166,85,81,2,31,1,1
65241,53,13968,53,484,102,382,4,36,2,2
58638,5900,0,0,62,62,0,1,0,1,0
443,4512,0,0,60,60,0,1,0,1,0
58638,5900,0,0,62,62,0,1,0,1,0
55660,53,37547,53,757,98,659,2,30,1,1
54792,443,48996,443,9515,2231,7284,25,22,14,11
63999,10552,13138,10552,66,66,0,2,8,2,0
49452,443,8798,443,16012,6573,9439,43,175,20,23
62443,445,0,0,70,70,0,1,0,1,0
57750,37965,0,0,62,62,0,1,0,1,0
49950,80,54747,80,3991,620,3371,14,15,7,7
55346,443,44978,443,13181,6041,7140,60,410,27,33
60367,443,45021,443,4847,963,3884,22,63,11,11
44235,50265,0,0,145,145,0,1,0,1,0
56215,53,9049,53,165,86,79,2,30,1,1
53204,445,0,0,70,70,0,1,0,1,0
51396,56205,0,0,66,66,0,1,0,1,0
58961,445,0,0,70,70,0,1,0,1,0
64622,36829,0,0,66,66,0,1,0,1,0
33047,443,1345,443,204,70,134,4,25,2,2
42137,443,46635,443,9173,2080,7093,22,18,13,9
51946,9407,10036,9407,70,70,0,2,7,2,0
37994,49152,32893,49152,156,156,0,3,8,3,0
51115,445,0,0,70,70,0,1,0,1,0
55968,53,21608,53,243,94,149,2,30,1,1
49167,53,55211,53,258,94,164,2,30,1,1
38859,22114,0,0,62,62,0,1,0,1,0
55622,53,55622,53,235,98,137,2,30,1,1
53237,443,53237,443,1210,637,573,14,34,7,7
65057,53,8165,53,211,94,117,2,30,1,1
60292,7129,0,0,62,62,0,1,0,1,0
64335,35440,0,0,62,62,0,1,0,1,0
50871,80,63200,80,94083,6192,87891,121,139,57,64
41328,53,51462,53,198,93,105,2,30,1,1
6881,6881,2586,6881,237,118,119,2,1200,1,1
35752,80,35752,80,871846,24071,847775,900,30,326,574
50270,445,0,0,70,70,0,1,0,1,0
59405,443,60870,443,9052,2120,6932,28,23,14,14
45964,55559,0,0,60,60,0,1,0,1,0
58745,443,47699,443,14654,9694,4960,36,17,19,17
55031,443,21855,443,134,60,74,3,5,2,1
63056,443,24879,443,304,86,218,2,30,1,1
58818,443,11066,443,1413,876,537,12,25,6,6
55056,53,38233,53,177,94,83,2,29,1,1
54455,443,54455,443,324001,46592,277409,409,177,203,206
19068,37965,0,0,62,62,0,1,0,1,0
49714,53,19961,53,490,101,389,4,45,2,2
1024,6881,0,0,62,62,0,1,0,1,0
51514,50584,0,0,62,62,0,1,0,1,0
61714,443,1566,443,2484,330,2154,12,135,5,7
54348,445,0,0,66,66,0,1,0,1,0
61592,443,6581,443,19544,8237,11307,29,121,13,16
36843,443,62939,443,1988,1348,640,16,30,9,7
57092,445,0,0,70,70,0,1,0,1,0
3478,61463,0,0,1049,1049,0,1,0,1,0
55199,53,58104,53,212,108,104,2,30,1,1
50963,445,0,0,66,66,0,1,0,1,0
61976,445,0,0,66,66,0,1,0,1,0
38358,80,53485,80,409,289,120,5,15,3,2
55043,57470,0,0,78,78,0,1,0,1,0
54443,445,0,0,66,66,0,1,0,1,0
57206,443,4994,443,1798,1223,575,13,28,8,5
55213,445,0,0,66,66,0,1,0,1,0
51573,53,28199,53,212,86,126,2,30,1,1
56869,17637,0,0,66,66,0,1,0,1,0
49843,53,21434,53,193,102,91,2,30,1,1
64703,53,15968,53,314,92,222,4,31,2,2
56508,80,35273,80,318,192,126,6,30,4,2
56929,53,14776,53,177,94,83,2,30,1,1
55131,445,0,0,70,70,0,1,0,1,0
64884,53,48287,53,239,110,129,2,30,1,1
5379,37965,0,0,62,62,0,1,0,1,0
16776,53,16776,53,197,90,107,2,30,1,1
51722,445,0,0,70,70,0,1,0,1,0
65234,53,47492,53,193,102,91,2,31,1,1
37619,443,7866,443,6169,4980,1189,28,16,15,13
56130,445,0,0,66,66,0,1,0,1,0
9452,443,55218,443,5693,499,5194,14,15,7,7
27824,51505,0,0,146,146,0,1,0,1,0
64967,53,42572,53,184,94,90,2,29,1,1
65285,445,0,0,70,70,0,1,0,1,0
62679,445,0,0,70,70,0,1,0,1,0
58272,445,0,0,66,66,0,1,0,1,0
49730,53,34658,53,194,102,92,2,30,1,1
49479,56205,0,0,62,62,0,1,0,1,0
63963,445,0,0,70,70,0,1,0,1,0
61711,35440,0,0,66,66,0,1,0,1,0
50245,44847,0,0,62,62,0,1,0,1,0
59763,445,0,0,70,70,0,1,0,1,0
45109,443,9498,443,190,70,120,4,15,2,2
13643,22114,0,0,146,146,0,1,0,1,0
61847,445,0,0,70,70,0,1,0,1,0
57413,445,0,0,70,70,0,1,0,1,0
57114,35440,0,0,146,146,0,1,0,1,0
56390,53,2004,53,701,88,613,2,30,1,1
56098,55442,0,0,66,66,0,1,0,1,0
57430,53,65274,53,177,94,83,2,30,1,1
30960,45763,2134,45763,330,330,0,6,3609,6,0
56377,445,0,0,70,70,0,1,0,1,0
19473,41049,5316,41049,149,149,0,1,1200,1,0
50358,80,31825,80,318,192,126,6,28,4,2
49384,53,27649,53,181,94,87,2,30,1,1
38065,443,63899,443,15799,7457,8342,42,98,22,20
64509,9571,0,0,62,62,0,1,0,1,0
49599,445,0,0,70,70,0,1,0,1,0
16330,50584,0,0,146,146,0,1,0,1,0
10586,37965,0,0,62,62,0,1,0,1,0
15503,55878,37795,55878,481,150,331,2,1200,1,1
65154,443,37170,443,5753,3034,2719,52,281,25,27
53261,443,44593,443,5025,973,4052,19,53,10,9
60537,445,0,0,66,66,0,1,0,1,0
50376,53,23494,53,166,86,80,2,31,1,1
61435,443,45257,443,1401,940,461,11,29,7,4
64467,53,41082,53,548,194,354,6,63,3,3
65171,445,0,0,70,70,0,1,0,1,0
9659,81,0,0,60,60,0,1,0,1,0
49227,443,49227,443,155471,20626,134845,193,95,92,101
37387,443,27821,443,64440,16508,47932,101,142,44,57
64354,53,25529,53,240,78,162,2,30,1,1
64561,53,50313,53,209,110,99,2,30,1,1
54463,445,0,0,70,70,0,1,0,1,0
63861,445,0,0,70,70,0,1,0,1,0
44086,443,28968,443,8542,4191,4351,84,616,46,38
58638,5900,0,0,62,62,0,1,0,1,0
54938,445,0,0,70,70,0,1,0,1,0
60117,50934,0,0,66,66,0,1,0,1,0
65112,53,30397,53,202,103,99,2,31,1,1
42157,443,25655,443,4819,2903,1916,29,81,15,14
49769,445,0,0,66,66,0,1,0,1,0
57309,443,42080,443,134,60,74,3,6,2,1
60489,53151,64380,53151,70,70,0,2,8,2,0
62489,23117,0,0,62,62,0,1,0,1,0
64016,53,54267,53,183,94,89,2,30,1,1
52099,28401,4027,28401,70,70,0,2,8,2,0
35666,22114,0,0,62,62,0,1,0,1,0
60724,445,0,0,66,66,0,1,0,1,0
58306,443,59387,443,864,436,428,13,29,7,6
38518,1900,0,0,139,139,0,1,0,1,0
37896,443,37896,443,4704,1797,2907,19,30,11,8
57201,53,46716,53,214,110,104,2,30,1,1
54215,443,45620,443,499,425,74,4,0,3,1
65336,53,55246,53,200,102,98,2,30,1,1
55687,47613,14281,47613,164,70,94,2,5,1,1
43025,443,51895,443,25223,13115,12108,63,116,33,30
57886,80,60119,80,6526,1210,5316,15,17,8,7
63583,443,3577,443,7339,2638,4701,33,167,18,15
64559,53,43720,53,168,86,82,2,30,1,1
18246,64097,0,0,62,62,0,1,0,1,0
56668,53,61467,53,701,88,613,2,30,1,1
55800,53,5218,53,177,94,83,2,30,1,1
54960,53,7818,53,448,184,264,6,30,3,3
62075,445,0,0,70,70,0,1,0,1,0
58836,51505,0,0,66,66,0,1,0,1,0
55117,445,0,0,70,70,0,1,0,1,0
56820,53,40391,53,193,102,91,2,30,1,1
65248,53,6844,53,446,106,340,4,47,2,2
65107,53,53716,53,193,102,91,2,30,1,1
59785,445,0,0,70,70,0,1,0,1,0
50544,443,24381,443,8592,1152,7440,25,150,13,12
53888,39204,51033,39204,70,70,0,1,5,1,0
27005,33055,54134,33055,888,126,762,2,31,1,1
60595,445,0,0,66,66,0,1,0,1,0
60806,445,0,0,66,66,0,1,0,1,0
56190,445,0,0,66,66,0,1,0,1,0
16319,44847,0,0,62,62,0,1,0,1,0
57749,445,0,0,70,70,0,1,0,1,0
64177,44847,0,0,66,66,0,1,0,1,0
58249,443,38085,443,4192,2267,1925,12,120,6,6
6666,3493,6666,3493,60,60,0,1,5,1,0
56561,443,57452,443,341343,9074,332269,353,121,122,231
56887,53,8046,53,250,87,163,4,57,2,2
50580,80,18240,80,1513,694,819,10,15,5,5
52949,443,60761,443,9564,2054,7510,42,114,20,22
63788,445,0,0,70,70,0,1,0,1,0
56326,53,54656,53,170,87,83,2,30,1,1
21133,51413,27138,51413,460,150,310,2,1199,1,1
51632,80,60453,80,502,256,246,9,39,5,4
60724,445,0,0,70,70,0,1,0,1,0
58289,445,0,0,70,70,0,1,0,1,0
12604,3389,12604,3389,293,223,70,4,1,3,1
56204,53,35086,53,195,102,93,2,30,1,1
56582,23718,0,0,62,62,0,1,0,1,0
56257,53,40161,53,177,94,83,2,30,1,1
49951,80,47463,80,38898,1623,37275,49,15,21,28
42030,25,0,0,74,74,0,1,0,1,0
54391,80,1850,80,1378,808,570,13,361,7,6
50518,53,60220,53,802,104,698,2,31,1,1
60416,55998,61754,55998,70,70,0,2,8,2,0
58638,5900,0,0,62,62,0,1,0,1,0
59598,445,0,0,70,70,0,1,0,1,0
2394,43890,0,0,62,62,0,1,0,1,0
5938,58817,0,0,60,60,0,1,90,1,0
58519,445,0,0,66,66,0,1,0,1,0
42927,443,28678,443,6921,1769,5152,22,24,13,9
65115,53,63102,53,301,95,206,4,36,2,2
25101,50584,0,0,62,62,0,1,0,1,0
65098,53,11310,53,260,94,166,2,30,1,1
63903,56016,63323,56016,312,132,180,6,6,3,3
54153,443,43773,443,5008,2097,2911,13,121,6,7
51289,445,0,0,70,70,0,1,0,1,0
57061,53,39332,53,1780,674,1106,18,68,9,9
50684,80,24128,80,57576,29602,27974,239,175,118,121
51995,50031,39289,50031,70,70,0,2,8,2,0
57896,443,11349,443,7332,3746,3586,37,176,19,18
64986,445,0,0,70,70,0,1,0,1,0
52176,443,22865,443,8048,1360,6688,24,23,12,12
49556,443,13898,443,6440,1844,4596,22,141,11,11
53715,443,59918,443,70,70,0,1,5,1,0
60593,80,31498,80,123436,6053,117383,165,241,83,82
57281,53,55108,53,178,94,84,2,30,1,1
49187,2710,53094,2710,70,70,0,1,5,1,0
63032,22114,0,0,66,66,0,1,0,1,0
55646,53,3427,53,183,94,89,2,30,1,1
40204,40005,24841,40005,148,86,62,2,30,1,1
56786,443,56786,443,4381,1474,2907,19,27,11,8
49893,25174,0,0,66,66,0,1,0,1,0
32746,50584,0,0,146,146,0,1,0,1,0
55619,53,44719,53,183,94,89,2,29,1,1
50332,53,15195,53,193,102,91,2,29,1,1
46525,53,46525,53,404,259,145,3,32,2,1
51839,80,51839,80,951054,20747,930307,902,26,276,626
49502,53,35075,53,179,86,93,2,29,1,1
56911,53,22477,53,211,78,133,2,30,1,1
13408,44847,0,0,62,62,0,1,0,1,0
63133,445,0,0,66,66,0,1,0,1,0
64132,445,0,0,66,66,0,1,0,1,0
49500,80,17093,80,309313,41646,267667,433,486,113,320
60246,445,0,0,70,70,0,1,0,1,0
64937,53,47101,53,210,110,100,2,30,1,1
57438,443,63629,443,7720,2815,4905,22,20,10,12
56689,443,17106,443,4857,3938,919,18,81,11,7
58638,5900,0,0,62,62,0,1,0,1,0
32967,443,43142,443,5327,963,4364,19,15,11,8
57911,443,43527,443,9662,4079,5583,66,194,30,36
8933,56205,0,0,62,62,0,1,0,1,0
52005,80,9480,80,46046,2705,43341,60,15,29,31
55330,53,61986,53,194,102,92,2,31,1,1
50098,53,37375,53,199,102,97,2,30,1,1
52686,53,56390,53,199,94,105,2,30,1,1
6881,6881,43192,6881,150,150,0,1,1200,1,0
50621,443,42155,443,3171,1473,1698,15,93,9,6
59198,445,0,0,66,66,0,1,0,1,0
50027,80,48247,80,3648,2069,1579,16,85,9,7
64312,53,26634,53,202,103,99,2,31,1,1
2383,37965,0,0,62,62,0,1,0,1,0
21870,53,21870,53,209,77,132,2,32,1,1
64224,53,56405,53,280,94,186,2,30,1,1
56670,443,55495,443,8308,3589,4719,25,19,15,10
51547,445,0,0,70,70,0,1,0,1,0
30114,65151,0,0,60,60,0,1,0,1,0
65384,53,45912,53,735,88,647,2,31,1,1
39983,80,39983,80,6416,997,5419,17,30,8,9
49500,443,11255,443,16888,2692,14196,42,150,22,20
60446,6882,2486,6882,70,70,0,2,8,2,0
58638,5900,58638,5900,130,66,64,2,4,1,1
33156,3478,41500,3478,338,110,228,2,300,1,1
60934,445,0,0,66,66,0,1,0,1,0
64664,53,45386,53,250,86,164,4,33,2,2
54223,445,0,0,66,66,0,1,0,1,0
65191,445,0,0,66,66,0,1,0,1,0
59191,443,56618,443,4489,2046,2443,23,121,11,12
61495,37965,0,0,66,66,0,1,0,1,0
55246,31573,0,0,66,66,0,1,0,1,0
44314,443,36123,443,1268867,60489,1208378,1558,141,557,1001
33067,53,0,0,86,86,0,1,30,1,0
49935,53,50105,53,177,94,83,2,30,1,1
50650,445,0,0,70,70,0,1,0,1,0
52939,443,34090,443,16053,6801,9252,51,115,26,25
56876,30188,0,0,66,66,0,1,0,1,0
52494,443,23008,443,5782,1008,4774,17,15,8,9
60617,64147,0,0,62,62,0,1,0,1,0
59395,445,0,0,70,70,0,1,0,1,0
9474,443,14729,443,6100,777,5323,17,26,9,8
65144,53,2841,53,210,110,100,2,29,1,1
53349,445,0,0,66,66,0,1,0,1,0
49262,53,27998,53,168,86,82,2,31,1,1
51531,443,29173,443,898,460,438,12,39,5,7
60991,445,0,0,70,70,0,1,0,1,0
28498,36237,0,0,146,146,0,1,0,1,0
53081,443,13924,443,16157,6478,9679,46,83,23,23
54070,443,51450,443,828875,45659,783216,1020,210,456,564
37168,443,5501,443,4871,923,3948,19,360,10,9
51899,47537,11729,47537,66,66,0,1,5,1,0
48697,5222,62184,5222,8355,4135,4220,79,616,41,38
55943,53,30420,53,448,184,264,6,29,3,3
59282,80,59282,80,181627,17128,164499,277,15,79,198
56362,445,0,0,70,70,0,1,0,1,0
55968,56205,0,0,66,66,0,1,0,1,0
59813,53,1465,53,355,118,237,2,30,1,1
53238,443,11082,443,27650,12347,15303,47,53,24,23
65038,53,25509,53,165,86,79,2,30,1,1
49449,80,5830,80,1948,912,1036,13,56,7,6
51334,443,42102,443,8407,2034,6373,19,121,8,11
58614,53,27670,53,218,78,140,2,31,1,1
14613,12446,0,0,66,66,0,1,0,1,0
46985,53,9920,53,199,94,105,2,30,1,1
49994,53,33575,53,86,86,0,1,29,1,0
53900,443,15989,443,499,425,74,4,0,3,1
64241,445,0,0,70,70,0,1,0,1,0
49670,53,37029,53,168,86,82,2,30,1,1
52390,2323,0,0,60,60,0,1,0,1,0
64183,445,0,0,70,70,0,1,0,1,0
56942,53,55677,53,177,94,83,2,30,1,1
50000,445,0,0,70,70,0,1,0,1,0
51324,465,51324,465,320,128,192,6,5,3,3
53894,443,56603,443,499,425,74,4,0,3,1
64216,53,1409,53,183,94,89,2,30,1,1
54672,443,53803,443,7210,2267,4943,22,15,12,10
56723,53,3556,53,198,94,104,2,30,1,1
64858,53,1882,53,227,102,125,2,30,1,1
41820,80,9493,80,1056,362,694,10,49,6,4
65436,53,49533,53,286,90,196,4,55,2,2
50000,53,56621,53,216,102,114,2,29,1,1
56873,445,0,0,70,70,0,1,0,1,0
53664,13701,26986,13701,70,70,0,1,4,1,0
65461,445,0,0,70,70,0,1,0,1,0
52240,52893,59916,52893,70,70,0,2,6,2,0
63007,445,0,0,70,70,0,1,0,1,0
64595,64147,0,0,62,62,0,1,0,1,0
49203,51050,0,0,62,62,0,1,0,1,0
57371,443,2707,443,5619,927,4692,17,15,10,7
19642,23,0,0,60,60,0,1,0,1,0
55658,445,0,0,66,66,0,1,0,1,0
59991,445,0,0,66,66,0,1,0,1,0
50306,445,0,0,70,70,0,1,0,1,0
56887,53,63111,53,177,94,83,2,30,1,1
21704,16933,0,0,62,62,0,1,0,1,0
10115,52700,0,0,62,62,0,1,0,1,0
56740,80,35362,80,1462,703,759,8,17,5,3
27323,23117,0,0,146,146,0,1,0,1,0
36411,443,59094,443,10691,3704,6987,25,181,13,12
15503,62336,46736,62336,127653507,122661116,4992391,161030,2162,82907,78123
60097,445,0,0,66,66,0,1,0,1,0
54348,443,31489,443,27760,9709,18051,56,45,27,29
49416,443,60402,443,625995,31468,594527,722,199,256,466
26900,27017,2675,27017,422,164,258,6,30,3,3
37906,37965,0,0,62,62,0,1,0,1,0
49165,53,64334,53,780,104,676,2,30,1,1
53661,34967,21536,34967,70,70,0,2,8,2,0
59247,53,59247,53,825,99,726,2,31,1,1
52267,443,8782,443,24712,9272,15440,65,136,34,31
54991,443,1653,443,20604,3530,17074,40,19,21,19
53342,443,18889,443,82909,70964,11945,139,283,71,68
50562,37965,0,0,66,66,0,1,0,1,0
59630,445,0,0,70,70,0,1,0,1,0
32961,80,43846,80,480,258,222,8,12,5,3
58502,445,0,0,66,66,0,1,0,1,0
21294,21247,0,0,146,146,0,1,0,1,0
58925,25174,0,0,66,66,0,1,0,1,0
1030,44847,0,0,62,62,0,1,0,1,0
33818,53,62977,53,168,78,90,2,30,1,1
49800,53,33373,53,183,94,89,2,29,1,1
51095,445,0,0,70,70,0,1,0,1,0
64428,53,26819,53,299,97,202,4,44,2,2
37680,443,40317,443,16742,3383,13359,57,309,28,29
50400,445,0,0,70,70,0,1,0,1,0
60505,53,0,0,340,90,250,2,31,1,1
62505,443,46992,443,14891,3970,10921,32,33,15,17
60766,28080,32813,28080,70,70,0,1,5,1,0
44047,443,38951,443,6750,4410,2340,19,120,9,10
30443,44847,0,0,62,62,0,1,0,1,0
60921,443,34285,443,9869,2448,7421,61,1253,24,37
59758,443,17824,443,4114,2557,1557,22,418,9,13
58543,6881,0,0,146,146,0,1,0,1,0
52522,445,0,0,66,66,0,1,0,1,0
57027,53,20222,53,198,94,104,2,30,1,1
56315,123,48493,123,184,94,90,2,30,1,1
4328,7302,0,0,66,66,0,1,0,1,0
52661,445,0,0,66,66,0,1,0,1,0
50063,35776,0,0,148,148,0,1,0,1,0
23001,64147,0,0,62,62,0,1,0,1,0
61009,27065,32929,27065,1582,1386,196,6,30,4,2
49589,53,16073,53,214,102,112,2,31,1,1
20706,37965,0,0,62,62,0,1,0,1,0
52903,443,59181,443,3478,1580,1898,21,31,12,9
50584,40420,46560,40420,868,150,718,4,1200,2,2
64332,53,6045,53,167,86,81,2,30,1,1
53880,445,0,0,66,66,0,1,0,1,0
52094,443,49643,443,3296065,47110,3248955,2746,51,533,2213
49640,443,55755,443,2809,1729,1080,18,80,10,8
56327,44512,0,0,66,66,0,1,0,1,0
49662,443,52708,443,4353,1145,3208,17,25,9,8
57470,6889,39885,6889,507,163,344,2,1200,1,1
54048,445,0,0,70,70,0,1,0,1,0
58638,5900,0,0,62,62,0,1,0,1,0
65028,53,59262,53,183,94,89,2,31,1,1
61147,445,0,0,70,70,0,1,0,1,0
55646,53,39790,53,760,97,663,2,31,1,1
61857,445,0,0,70,70,0,1,0,1,0
55694,53,60951,53,167,86,81,2,30,1,1
30574,64147,0,0,62,62,0,1,0,1,0
56929,53,5055,53,170,87,83,2,30,1,1
65427,53,25865,53,677,188,489,6,57,3,3
65007,53,25080,53,180,86,94,2,30,1,1
19875,30170,0,0,145,145,0,1,0,1,0
55933,53,55116,53,330,92,238,4,43,2,2
56359,443,2986,443,3734,1750,1984,24,203,12,12
53084,443,55326,443,490914,83866,407048,1048,332,526,522
64112,443,40510,443,4116645,96572,4020073,4029,58,1356,2673
47052,80,21524,80,1217,486,731,8,43,5,3
37857,443,49755,443,7051,5086,1965,32,100,18,14
62587,445,0,0,70,70,0,1,0,1,0
48676,53399,0,0,60,60,0,1,0,1,0
57556,443,34647,443,7087,2587,4500,21,30,12,9
27005,32038,39933,32038,868,126,742,2,30,1,1
55044,80,26880,80,306,180,126,6,34,4,2
50726,445,0,0,70,70,0,1,0,1,0
57348,445,0,0,66,66,0,1,0,1,0
51270,445,0,0,70,70,0,1,0,1,0
52625,53,52625,53,231,88,143,2,32,1,1
57263,445,0,0,70,70,0,1,0,1,0
61351,445,0,0,70,70,0,1,0,1,0
65251,53,54208,53,183,98,85,3,36,2,1
41028,80,41028,80,100182,8294,91888,137,127,69,68
54033,443,51149,443,43491,8521,34970,69,50,34,35
13285,29892,0,0,145,145,0,1,0,1,0
37588,443,34121,443,499,425,74,4,0,3,1
40737,443,35009,443,44004,3909,40095,80,135,38,42
56326,56205,0,0,66,66,0,1,0,1,0
53928,15503,0,0,145,145,0,1,0,1,0
64611,445,0,0,70,70,0,1,0,1,0
48350,57470,0,0,74,74,0,1,0,1,0
34066,36829,0,0,146,146,0,1,0,1,0
55037,443,21745,443,2639,258,2381,9,120,4,5
43475,443,10490,443,5578,1646,3932,23,16,13,10
52869,445,0,0,70,70,0,1,0,1,0
0,0,0,0,156,156,0,2,0,2,0
49604,53,29103,53,89,89,0,1,30,1,0
50587,80,50587,80,1711,1011,700,11,21,6,5
62465,445,0,0,70,70,0,1,0,1,0
11023,51505,0,0,62,62,0,1,0,1,0
58314,445,0,0,66,66,0,1,0,1,0
55760,443,60909,443,12723734,404530,12319204,13539,134,4494,9045
52788,64147,0,0,66,66,0,1,0,1,0
49636,44847,0,0,62,62,0,1,0,1,0
58022,8080,0,0,60,60,0,1,0,1,0
46859,50584,0,0,62,62,0,1,0,1,0
58568,445,0,0,66,66,0,1,0,1,0
49927,53,25486,53,763,102,661,2,30,1,1
55633,53,59677,53,195,102,93,2,30,1,1
56236,80,56236,80,44755,823,43932,45,15,12,33
55469,53,3156,53,193,102,91,2,30,1,1
40355,443,8929,443,15367456,244322,15123134,12866,268,1819,11047
53574,23650,56670,23650,320,140,180,6,5,3,3
56644,443,53305,443,3079,1895,1184,18,16,10,8
50539,80,55226,80,5912,3532,2380,15,31,8,7
54814,445,0,0,70,70,0,1,0,1,0
65294,445,0,0,70,70,0,1,0,1,0
0,0,0,0,320,320,0,5,0,5,0
26531,37965,0,0,62,62,0,1,0,1,0
49001,40108,0,0,161,161,0,1,0,1,0
50116,443,45796,443,48255,4798,43457,100,149,47,53
48287,443,53104,443,416,210,206,7,96,4,3
50289,53,1310,53,189,102,87,2,30,1,1
33432,5900,0,0,60,60,0,1,0,1,0
50238,53,50499,53,438,180,258,6,30,3,3
60473,8765,34134,8765,199,75,124,4,59,2,2
37965,32405,17637,32405,766,248,518,4,1200,2,2
52536,445,0,0,66,66,0,1,0,1,0
49981,53,44663,53,360,102,258,2,30,1,1
49569,53,48621,53,91,91,0,2,37,2,0
46318,443,20839,443,6373,1744,4629,22,15,13,9
41764,443,65468,443,9028,5092,3936,36,257,12,24
54988,445,0,0,66,66,0,1,0,1,0
44207,44847,0,0,66,66,0,1,0,1,0
64813,53,4341,53,180,94,86,2,30,1,1
51048,445,0,0,70,70,0,1,0,1,0
3410,17372,0,0,62,62,0,1,0,1,0
10333,22114,0,0,62,62,0,1,0,1,0
57000,53,25419,53,188,96,92,2,31,1,1
60520,53,60520,53,198,90,108,2,30,1,1
1912,48817,0,0,62,62,0,1,0,1,0
65103,445,0,0,66,66,0,1,0,1,0
65245,53,21925,53,184,102,82,2,30,1,1
53528,20485,28809,20485,70,70,0,1,5,1,0
59402,445,0,0,66,66,0,1,0,1,0
50605,80,50605,80,2909,1798,1111,14,23,8,6
52541,53,60922,53,242,78,164,2,29,1,1
34489,35440,0,0,62,62,0,1,0,1,0
35965,443,35465,443,14940,9434,5506,30,105,17,13
49266,53,11642,53,330,97,233,4,33,2,2
54727,445,0,0,70,70,0,1,0,1,0
53948,7370,62549,7370,70,70,0,1,5,1,0
50558,445,0,0,70,70,0,1,0,1,0
53194,35440,0,0,66,66,0,1,0,1,0
58057,80,11789,80,2708,1386,1322,23,75,12,11
55288,443,7334,443,15679,1532,14147,16,139,3,13
26800,22,0,0,60,60,0,1,0,1,0
53980,443,7192,443,4957,1627,3330,17,120,8,9
59096,57866,0,0,66,66,0,1,0,1,0
57470,8621,39581,8621,469,150,319,2,1199,1,1
42298,40031,8368,40031,157,94,63,2,30,1,1
60972,445,0,0,70,70,0,1,0,1,0
57259,53,28924,53,167,86,81,2,29,1,1
54496,53,1798,53,164,86,78,2,29,1,1
55252,445,0,0,70,70,0,1,0,1,0
64723,443,61032,443,7978900,79979,7898921,6464,210,644,5820
56648,443,26064,443,8007,1987,6020,20,15,11,9
63005,445,0,0,66,66,0,1,0,1,0
55323,53,29422,53,279,94,185,2,30,1,1
57208,53,39529,53,183,94,89,2,30,1,1
49285,53,48057,53,168,78,90,2,30,1,1
50408,53,36344,53,182,93,89,2,31,1,1
16387,56995,0,0,60,60,0,1,0,1,0
58338,3369,0,0,60,60,0,1,0,1,0
58870,443,34912,443,21207,14062,7145,50,19,28,22
29577,64147,0,0,62,62,0,1,0,1,0
58638,5900,0,0,62,62,0,1,0,1,0
9687,57470,0,0,78,78,0,1,0,1,0
49927,445,0,0,70,70,0,1,0,1,0
56360,53,64885,53,711,87,624,2,30,1,1
57964,445,0,0,70,70,0,1,0,1,0
50186,443,39007,443,6440,1603,4837,23,361,11,12
55868,445,0,0,70,70,0,1,0,1,0
48521,53,27557,53,78,78,0,1,30,1,0
49365,53,39023,53,195,102,93,2,30,1,1
61732,3389,61732,3389,3380,1730,1650,15,33,8,7
50971,445,0,0,70,70,0,1,0,1,0
52282,37965,0,0,66,66,0,1,0,1,0
64708,53,37304,53,437,89,348,4,48,2,2
27005,27050,14571,27050,1684,126,1558,4,31,2,2
34616,443,64459,443,9265,4429,4836,23,18,14,9
57139,53,34151,53,166,86,80,2,29,1,1
51991,445,0,0,70,70,0,1,0,1,0
52821,445,0,0,70,70,0,1,0,1,0
35507,15503,0,0,62,62,0,1,0,1,0
45941,23386,0,0,60,60,0,1,0,1,0
54360,445,0,0,70,70,0,1,0,1,0
64379,37965,0,0,66,66,0,1,0,1,0
56432,35253,0,0,66,66,0,1,0,1,0
54371,80,58322,80,3623,1718,1905,17,186,10,7
33459,80,37833,80,1658,1344,314,10,14,5,5
49610,53,38769,53,754,94,660,2,30,1,1
54979,443,32141,443,643217,29500,613717,787,53,338,449
37877,80,30834,80,991,483,508,9,181,5,4
64767,443,64767,443,4507,1600,2907,19,31,11,8
64824,36829,0,0,66,66,0,1,0,1,0
58638,5900,0,0,62,62,0,1,0,1,0
49354,53,30111,53,192,98,94,2,31,1,1
39392,80,20430,80,1325,442,883,16,414,4,12
47500,443,47942,443,7464,2375,5089,15,120,7,8
60377,443,48988,443,8588,2020,6568,20,76,10,10
49294,53,26484,53,723,102,621,2,30,1,1
58949,445,0,0,70,70,0,1,0,1,0
58286,37965,0,0,66,66,0,1,0,1,0
22542,30188,0,0,62,62,0,1,0,1,0
58638,5900,0,0,62,62,0,1,0,1,0
55305,53,27046,53,176,176,0,3,46,3,0
58472,53,5380,53,86,86,0,1,30,1,0
52830,445,0,0,70,70,0,1,0,1,0
61399,445,0,0,66,66,0,1,0,1,0
54604,80,54604,80,2244,1549,695,11,18,7,4
60347,445,0,0,70,70,0,1,0,1,0
59037,28370,0,0,62,62,0,1,0,1,0
49418,27016,22907,27016,254,71,183,2,30,1,1
60350,51505,0,0,66,66,0,1,0,1,0
37826,23,0,0,60,60,0,1,0,1,0
53930,445,0,0,70,70,0,1,0,1,0
61911,445,0,0,66,66,0,1,0,1,0
16221,50584,0,0,146,146,0,1,0,1,0
55095,445,0,0,66,66,0,1,0,1,0
63031,443,4313,443,304,86,218,2,29,1,1
64749,53,21766,53,227,110,117,2,30,1,1
49319,53,39564,53,199,102,97,2,29,1,1
64360,53,15501,53,350,88,262,4,31,2,2
52801,443,38731,443,8308,3201,5107,36,1401,19,17
51383,445,0,0,66,66,0,1,0,1,0
49514,52255,0,0,162,162,0,1,0,1,0
53977,22266,9645,22266,492,306,186,8,17,5,3
64904,53,60868,53,198,101,97,2,31,1,1
27005,50001,15883,50001,1656,126,1530,4,31,2,2
9731,64147,0,0,62,62,0,1,0,1,0
60123,443,13855,443,6485,1957,4528,22,16,11,11
16387,64075,0,0,60,60,0,1,0,1,0
34600,80,41483,80,3089,775,2314,15,16,9,6
53137,35111,32550,35111,70,70,0,1,5,1,0
0,0,0,0,82,82,0,1,0,1,0
57350,53,37868,53,177,94,83,2,30,1,1
37585,443,50718,443,499,425,74,4,2,3,1
55808,53,53764,53,730,102,628,2,30,1,1
38926,37965,0,0,62,62,0,1,0,1,0
50876,80,52453,80,121344,7345,113999,144,141,61,83
56562,53,4746,53,183,94,89,2,29,1,1
55498,445,0,0,70,70,0,1,0,1,0
36837,443,3546,443,9311,1387,7924,20,31,10,10
50897,445,0,0,70,70,0,1,0,1,0
52516,80,41641,80,3224,2776,448,11,15,7,4
49424,53,45939,53,198,102,96,2,32,1,1
54572,445,0,0,66,66,0,1,0,1,0
58851,443,62485,443,15848,13507,2341,37,32,19,18
50552,445,0,0,66,66,0,1,0,1,0
9203,443,1918,443,318,192,126,6,17,4,2
39287,53,1937,53,198,93,105,2,30,1,1
52718,445,0,0,70,70,0,1,0,1,0
50991,445,0,0,70,70,0,1,0,1,0
59626,22114,0,0,62,62,0,1,0,1,0
41486,1433,0,0,60,60,0,1,0,1,0
50161,53,38218,53,165,86,79,2,30,1,1
11816,50584,0,0,62,62,0,1,0,1,0
0,0,0,0,156,156,0,2,0,2,0
54889,443,57896,443,5541,3309,2232,19,61,11,8
56050,53,45376,53,178,94,84,2,30,1,1
63542,15503,0,0,66,66,0,1,0,1,0
52015,80,59849,80,14830,11044,3786,27,37,15,12
56864,15646,57596,15646,70,70,0,1,5,1,0
54867,445,0,0,70,70,0,1,0,1,0
62453,443,7833,443,8698,3272,5426,22,26,11,11
53923,443,32187,443,499,425,74,4,0,3,1
49169,443,62824,443,11168,3827,7341,42,16,20,22
9529,26467,0,0,62,62,0,1,0,1,0
56009,53,53982,53,178,94,84,2,30,1,1
41231,443,41940,443,65667,5371,60296,89,85,36,53
49737,53,34228,53,184,86,98,2,31,1,1
63109,445,0,0,70,70,0,1,0,1,0
56139,53,55354,53,306,94,212,2,30,1,1
34301,21247,0,0,146,146,0,1,0,1,0
52851,445,0,0,70,70,0,1,0,1,0
64870,65473,0,0,148,148,0,1,0,1,0
64905,53,62456,53,283,102,181,2,30,1,1
51996,35440,0,0,66,66,0,1,0,1,0
24534,50584,0,0,146,146,0,1,0,1,0
63106,445,0,0,70,70,0,1,0,1,0
5223,44091,0,0,220,220,0,1,0,1,0
58811,53976,0,0,62,62,0,1,0,1,0
27005,27015,3156,27015,878,126,752,2,30,1,1
57206,123,21797,123,184,94,90,2,30,1,1
49845,443,54304,443,8518,2260,6258,32,806,12,20
59218,445,0,0,70,70,0,1,0,1,0
63647,445,0,0,66,66,0,1,0,1,0
47040,25174,0,0,62,62,0,1,0,1,0
52121,58933,11142,58933,66,66,0,1,5,1,0
63976,53,54161,53,200,102,98,2,33,1,1
61550,5529,0,0,145,145,0,1,0,1,0
55469,53,16063,53,817,98,719,2,31,1,1
7947,50584,0,0,62,62,0,1,0,1,0
58760,445,0,0,70,70,0,1,0,1,0
55454,53,12163,53,168,86,82,2,32,1,1
50687,445,0,0,70,70,0,1,0,1,0
32976,37965,0,0,66,66,0,1,0,1,0
53858,6889,25438,6889,372,186,186,6,16,3,3
11136,19910,0,0,62,62,0,1,0,1,0
64628,53,26706,53,753,93,660,2,30,1,1
64378,53,28947,53,273,94,179,2,30,1,1
61279,443,14356,443,7424,3871,3553,26,160,12,14
55367,53,46146,53,195,102,93,2,31,1,1
56340,53,20646,53,780,104,676,2,30,1,1
65058,445,0,0,70,70,0,1,0,1,0
50325,445,0,0,66,66,0,1,0,1,0
64053,53,35360,53,193,102,91,2,29,1,1
54940,445,0,0,70,70,0,1,0,1,0
50522,445,0,0,70,70,0,1,0,1,0
57015,53,61760,53,279,94,185,2,30,1,1
56415,53,6839,53,198,101,97,2,30,1,1
55940,445,0,0,70,70,0,1,0,1,0
49462,53,10345,53,86,86,0,1,30,1,0
55786,53,33325,53,177,94,83,2,30,1,1
61845,11392,0,0,66,66,0,1,0,1,0
65292,53,10766,53,385,106,279,4,33,2,2
56871,53,27631,53,198,86,112,2,30,1,1
61671,445,0,0,66,66,0,1,0,1,0
65413,53,65505,53,266,110,156,2,30,1,1
49632,7000,49632,7000,1236,676,560,13,15,7,6
37749,15503,0,0,62,62,0,1,0,1,0
49904,53,31561,53,217,94,123,2,29,1,1
63320,445,0,0,66,66,0,1,0,1,0
63999,53,43877,53,186,95,91,2,30,1,1
58852,443,26155,443,3723,1793,1930,21,69,10,11
37569,443,55677,443,120566,15345,105221,173,125,72,101
56606,445,0,0,66,66,0,1,0,1,0
50738,445,0,0,70,70,0,1,0,1,0
64677,53,61310,53,183,94,89,2,31,1,1
55155,53,35899,53,194,102,92,2,31,1,1
49795,443,22996,443,7243,777,6466,17,126,8,9
53906,443,56748,443,499,425,74,4,0,3,1
51866,23431,28853,23431,70,70,0,1,5,1,0
54134,443,5561,443,10425,1383,9042,23,75,13,10
31019,53,31019,53,194,87,107,2,30,1,1
63961,53,2242,53,373,171,202,5,40,3,2
15239,53,15239,53,229,89,140,2,30,1,1
64428,53,57120,53,190,97,93,2,31,1,1
60993,445,0,0,70,70,0,1,0,1,0
51132,80,62444,80,426,240,186,8,21,5,3
64673,445,0,0,70,70,0,1,0,1,0
54540,443,17427,443,6680,3784,2896,18,135,9,9
49157,53,42050,53,184,94,90,2,29,1,1
58913,443,48481,443,5264,3357,1907,21,17,11,10
63854,16437,39591,16437,66,66,0,2,7,2,0
52503,50584,0,0,66,66,0,1,0,1,0
45941,23386,0,0,60,60,0,1,0,1,0
64679,53,17226,53,211,102,109,2,31,1,1
51568,445,0,0,70,70,0,1,0,1,0
56357,53,35688,53,270,110,160,2,30,1,1
48972,443,48972,443,4657,1750,2907,19,31,11,8
51555,443,44960,443,876,390,486,12,39,4,8
0,0,0,0,98,98,0,1,0,1,0
57270,443,35956,443,9415,3482,5933,57,16,29,28
58079,445,0,0,66,66,0,1,0,1,0
33941,37807,0,0,62,62,0,1,0,1,0
58840,443,27383,443,5108,700,4408,15,15,7,8
57816,445,0,0,70,70,0,1,0,1,0
55563,443,55563,443,4628,1721,2907,19,30,11,8
65265,445,0,0,70,70,0,1,0,1,0
53583,15354,6378,15354,70,70,0,2,7,2,0
26351,22114,0,0,62,62,0,1,0,1,0
63460,445,0,0,70,70,0,1,0,1,0
33115,443,15120,443,75816,2178,73638,72,16,20,52
50729,27029,59296,27029,269,78,191,2,30,1,1
28007,443,40494,443,31586,15587,15999,213,884,105,108
64376,445,0,0,66,66,0,1,0,1,0
41561,23,0,0,60,60,0,1,0,1,0
57433,21247,0,0,66,66,0,1,0,1,0
56323,57470,0,0,74,74,0,1,0,1,0
23613,53,55694,53,177,94,83,2,29,1,1
49498,53,33432,53,211,102,109,2,30,1,1
49964,445,0,0,70,70,0,1,0,1,0
53481,445,0,0,70,70,0,1,0,1,0
9231,443,14526,443,4942,429,4513,12,15,6,6
60248,46776,0,0,66,66,0,1,0,1,0
52006,49849,11177,49849,70,70,0,2,7,2,0
50975,80,56708,80,1095845,7641,1088204,839,35,114,725
56928,80,39650,80,526,304,222,8,35,5,3
55807,80,55807,80,424,198,226,7,142,4,3
60204,445,0,0,66,66,0,1,0,1,0
59216,445,0,0,70,70,0,1,0,1,0
55071,53,59621,53,177,94,83,2,30,1,1
52312,443,50036,443,1574859,55851,1519008,1758,185,656,1102
54267,445,0,0,66,66,0,1,0,1,0
42607,443,6741,443,10221,3259,6962,36,120,18,18
27005,27055,18786,27055,915,126,789,2,30,1,1
57996,80,13904,80,5411,3618,1793,27,75,14,13
52932,443,63575,443,13165,3626,9539,56,115,30,26
53728,445,0,0,70,70,0,1,0,1,0
65040,53,64566,53,180,94,86,2,29,1,1
57508,445,0,0,70,70,0,1,0,1,0
49474,443,32026,443,10315,2018,8297,24,158,12,12
52509,445,0,0,70,70,0,1,0,1,0
41350,80,41350,80,1914,1465,449,10,19,6,4
55441,445,0,0,70,70,0,1,0,1,0
46438,53,32231,53,222,78,144,2,30,1,1
44949,53,44949,53,198,90,108,2,30,1,1
49402,443,59952,443,7965,4044,3921,63,464,30,33
65328,445,0,0,70,70,0,1,0,1,0
53817,443,11999,443,7443,2043,5400,34,255,17,17
62774,445,0,0,70,70,0,1,0,1,0
49777,53,28087,53,216,110,106,2,30,1,1
58392,3389,58392,3389,4624,1524,3100,17,17,9,8
62080,54532,0,0,60,60,0,1,0,1,0
43688,22114,0,0,66,66,0,1,0,1,0
55891,445,0,0,66,66,0,1,0,1,0
52604,25174,0,0,62,62,0,1,0,1,0
30583,25174,0,0,66,66,0,1,0,1,0
52663,445,0,0,70,70,0,1,0,1,0
58060,445,0,0,66,66,0,1,0,1,0
55187,53,45900,53,172,94,78,2,29,1,1
27005,27017,24115,27017,880,126,754,2,30,1,1
37183,443,43656,443,9631,4184,5447,33,271,17,16
51754,18375,0,0,62,62,0,1,0,1,0
64923,25174,0,0,66,66,0,1,0,1,0
64519,53,15868,53,518,185,333,6,60,3,3
58638,5900,0,0,62,62,0,1,0,1,0
54018,445,0,0,70,70,0,1,0,1,0
58120,53,58120,53,825,99,726,2,30,1,1
52089,445,0,0,70,70,0,1,0,1,0
53692,445,0,0,66,66,0,1,0,1,0
5223,14446,0,0,220,220,0,1,0,1,0
63675,445,0,0,66,66,0,1,0,1,0
51240,443,5101,443,9668,4688,4980,42,16,25,17
55192,53,17598,53,178,94,84,2,30,1,1
52001,445,0,0,70,70,0,1,0,1,0
48362,443,23544,443,8075,1766,6309,22,78,13,9
61626,445,0,0,70,70,0,1,0,1,0
49725,443,10242,443,311104,8270,302834,336,18,99,237
80,53945,0,0,60,60,0,1,0,1,0
52998,443,2559,443,190,70,120,4,15,2,2
45913,443,64072,443,4046,967,3079,13,27,7,6
52437,445,0,0,70,70,0,1,0,1,0
52146,445,0,0,66,66,0,1,0,1,0
55804,445,0,0,66,66,0,1,0,1,0
13528,51221,0,0,62,62,0,1,0,1,0
60477,445,0,0,70,70,0,1,0,1,0
58031,443,14165,443,1314,653,661,13,185,7,6
33107,443,39338,443,35031,3490,31541,60,363,28,32
37592,36829,0,0,146,146,0,1,0,1,0
2598,23718,0,0,66,66,0,1,0,1,0
53214,80,58168,80,19877,856,19021,22,16,6,16
39011,80,17481,80,1114,534,580,12,15,7,5
54103,445,0,0,70,70,0,1,0,1,0
55715,443,55715,443,4575,1668,2907,19,30,11,8
52951,445,0,0,70,70,0,1,0,1,0
61183,445,0,0,70,70,0,1,0,1,0
55587,43890,0,0,66,66,0,1,0,1,0
55992,53,33542,53,194,94,100,2,30,1,1
63621,445,0,0,70,70,0,1,0,1,0
9136,80,1532,80,908,842,66,7,15,6,1
60951,445,0,0,66,66,0,1,0,1,0
55996,443,19878,443,5323,2482,2841,31,19,15,16
55649,53,24364,53,216,110,106,2,30,1,1
48483,443,20913,443,60944,9555,51389,71,362,25,46
55705,53,50083,53,209,110,99,2,30,1,1
50328,22114,0,0,66,66,0,1,0,1,0
56186,53,13478,53,198,102,96,2,31,1,1
61002,37965,0,0,145,145,0,1,0,1,0
17173,23,0,0,60,60,0,1,0,1,0
55487,53,60324,53,199,102,97,2,31,1,1
51852,80,36581,80,182,60,122,4,29,2,2
42298,40001,45646,40001,156,94,62,2,30,1,1
65304,53,2754,53,202,103,99,2,31,1,1
51962,1024,18199,1024,316,136,180,6,5,3,3
52521,80,12951,80,3676,3228,448,11,15,7,4
58638,5900,0,0,62,62,0,1,0,1,0
63991,443,63991,443,4597,1690,2907,19,28,11,8
49491,443,61216,443,33157,17446,15711,66,135,38,28
59401,443,58968,443,3010,1892,1118,16,15,8,8
65289,46776,0,0,66,66,0,1,0,1,0
57570,443,57570,443,175212,28668,146544,186,180,69,117
64256,445,0,0,70,70,0,1,0,1,0
64613,53,44378,53,179,94,85,2,30,1,1
54100,80,44998,80,78,78,0,1,5,1,0
26900,27017,55723,27017,20322,11404,8918,118,133,67,51
52856,443,43323,443,5495,1303,4192,17,15,9,8
60373,445,0,0,66,66,0,1,0,1,0
14352,8055,0,0,148,148,0,1,0,1,0
54888,443,50282,443,1775,169,1606,7,122,3,4
51221,27048,22916,27048,132,132,0,3,1200,3,0
51951,443,35308,443,3854,1151,2703,20,135,10,10
51843,445,0,0,70,70,0,1,0,1,0
60417,55100,30057,55100,258,70,188,4,8,2,2
47038,443,65328,443,2809,1884,925,19,24,11,8
11136,17500,0,0,62,62,0,1,0,1,0
56281,53,4042,53,177,94,83,2,30,1,1
61402,445,0,0,70,70,0,1,0,1,0
49571,443,45165,443,3972,887,3085,13,31,6,7
43601,443,18392,443,10274,3806,6468,26,413,14,12
59584,36237,0,0,66,66,0,1,0,1,0
57320,443,20383,443,5989,926,5063,19,14,10,9
56277,445,0,0,66,66,0,1,0,1,0
61839,445,0,0,70,70,0,1,0,1,0
6037,43890,0,0,74,74,0,1,0,1,0
56581,80,13177,80,1630,918,712,12,17,7,5
53809,445,0,0,66,66,0,1,0,1,0
43704,37965,0,0,66,66,0,1,0,1,0
50608,80,12728,80,10029,8683,1346,20,36,11,9
50767,57470,0,0,62,62,0,1,0,1,0
34354,443,64555,443,3603,562,3041,10,15,6,4
57606,80,57606,80,11536,3264,8272,29,37,15,14
50964,445,0,0,70,70,0,1,0,1,0
50478,443,64929,443,36345,2308,34037,52,83,23,29
59937,37965,0,0,66,66,0,1,0,1,0
52155,80,42520,80,1056,682,374,10,15,6,4
51753,445,0,0,70,70,0,1,0,1,0
56575,445,0,0,70,70,0,1,0,1,0
56503,53,8942,53,916,86,830,2,31,1,1
50803,445,0,0,70,70,0,1,0,1,0
51221,51413,6783,51413,459,149,310,2,1201,1,1
49567,53,58916,53,244,94,150,2,29,1,1
57412,445,0,0,70,70,0,1,0,1,0
13654,50584,0,0,62,62,0,1,0,1,0
24292,48817,0,0,148,148,0,1,0,1,0
55262,53,4967,53,193,102,91,2,30,1,1
64895,53,23891,53,199,102,97,2,29,1,1
18011,44847,0,0,66,66,0,1,0,1,0
53724,443,54768,443,499,425,74,4,0,3,1
56707,443,22633,443,8005,1985,6020,20,15,11,9
50898,445,0,0,70,70,0,1,0,1,0
46385,53,10375,53,199,94,105,2,30,1,1
55736,53,0,0,623,70,553,2,30,1,1
65292,53,3636,53,195,102,93,2,30,1,1
58829,445,0,0,66,66,0,1,0,1,0
49570,443,54043,443,1013,492,521,10,30,4,6
57371,445,0,0,70,70,0,1,0,1,0
5588,5588,0,0,3562,1936,1626,48,192,24,24
56254,53,3663,53,498,204,294,6,30,3,3
61455,64147,0,0,66,66,0,1,0,1,0
56489,53,16732,53,208,106,102,2,31,1,1
57262,53,58338,53,180,94,86,2,30,1,1
56256,445,0,0,66,66,0,1,0,1,0
61234,443,50660,443,1786,172,1614,7,120,3,4
55246,31573,0,0,62,62,0,1,0,1,0
58950,5900,0,0,60,60,0,1,0,1,0
51077,80,9544,80,9133,1055,8078,17,151,8,9
59511,445,0,0,70,70,0,1,0,1,0
1663,30188,0,0,66,66,0,1,0,1,0
53036,445,0,0,70,70,0,1,0,1,0
60763,445,0,0,66,66,0,1,0,1,0
53437,6057,54615,6057,245,245,0,2,30,2,0
55890,53,43973,53,193,102,91,2,30,1,1
50935,80,12497,80,40645,6133,34512,66,274,33,33
49585,445,0,0,66,66,0,1,0,1,0
50375,50584,0,0,62,62,0,1,0,1,0
17579,57470,0,0,62,62,0,1,0,1,0
65056,53,56800,53,270,94,176,2,30,1,1
9440,443,42891,443,7573,1528,6045,22,33,11,11
61508,443,13468,443,215490,8471,207019,194,45,45,149
49800,53,14799,53,183,94,89,2,30,1,1
56797,443,58873,443,8022,2002,6020,20,16,11,9
56185,53,61715,53,168,86,82,2,30,1,1
51398,445,0,0,70,70,0,1,0,1,0
65006,53,63104,53,994,86,908,2,30,1,1
54127,445,0,0,70,70,0,1,0,1,0
59101,445,0,0,66,66,0,1,0,1,0
51412,53,4036,53,252,78,174,2,30,1,1
59210,50584,0,0,62,62,0,1,0,1,0
33609,443,62063,443,9348,1018,8330,22,256,11,11
64090,53,12119,53,227,102,125,2,30,1,1
57133,445,0,0,70,70,0,1,0,1,0
62348,443,31303,443,1592,965,627,15,20,7,8
37614,53,37614,53,209,98,111,2,30,1,1
50372,443,12434,443,456,390,66,4,0,3,1
50881,80,32099,80,128327,7366,120961,154,141,67,87
54924,443,37000,443,62,62,0,1,4,1,0
32299,40019,4671,40019,148,86,62,2,30,1,1
54432,445,0,0,66,66,0,1,0,1,0
53419,28189,0,0,60,60,0,1,0,1,0
55866,53,14599,53,168,78,90,2,30,1,1
57235,15187,23276,15187,1269359015,948477220,320881795,1036116,9283,747520,288596
63873,44847,0,0,66,66,0,1,0,1,0
64792,53,58723,53,768,99,669,2,31,1,1
49777,53,2324,53,485,79,406,4,31,2,2
35797,53,35797,53,217,90,127,2,30,1,1
62921,993,3682,993,8856,4253,4603,79,27,42,37
56175,445,0,0,66,66,0,1,0,1,0
63035,443,64744,443,1864,250,1614,8,120,4,4
60728,445,0,0,70,70,0,1,0,1,0
57587,80,57587,80,218150,5323,212827,218,145,69,149
19594,23117,0,0,66,66,0,1,0,1,0
53543,445,0,0,70,70,0,1,0,1,0
55142,26467,0,0,66,66,0,1,0,1,0
51221,33295,49216,33295,528,528,0,9,1200,9,0
61187,443,13311,443,4862,1820,3042,14,120,7,7
9588,37965,0,0,62,62,0,1,0,1,0
55415,53,7035,53,183,94,89,2,30,1,1
65332,56205,0,0,66,66,0,1,0,1,0
55415,53,34000,53,182,93,89,2,31,1,1
60891,445,0,0,70,70,0,1,0,1,0
49952,53,48831,53,195,102,93,2,30,1,1
51414,50584,0,0,62,62,0,1,0,1,0
65158,53,9153,53,728,102,626,2,30,1,1
56887,53,53946,53,250,87,163,4,60,2,2
64800,80,8529,80,508,256,252,9,75,5,4
29964,53,52267,53,200,86,114,2,30,1,1
59798,443,49371,443,1887,1152,735,18,28,9,9
49245,53,23757,53,195,102,93,2,30,1,1
58638,5900,0,0,62,62,0,1,0,1,0
61482,445,0,0,70,70,0,1,0,1,0
51953,37965,0,0,66,66,0,1,0,1,0
50896,445,0,0,70,70,0,1,0,1,0
56463,443,48725,443,6364,1147,5217,19,24,11,8
51909,33509,56937,33509,70,70,0,1,5,1,0
55201,26467,0,0,66,66,0,1,0,1,0
65105,80,65105,80,23382,3770,19612,48,45,24,24
60067,443,11544,443,14085,1879,12206,27,141,12,15
16660,55783,0,0,62,62,0,1,0,1,0
123,123,52430,123,184,94,90,2,30,1,1
61622,445,0,0,66,66,0,1,0,1,0
3382,53,3382,53,220,100,120,2,31,1,1
58893,443,9531,443,5107,700,4407,15,15,7,8
55455,443,13171,443,1786,172,1614,7,120,3,4
62379,445,0,0,70,70,0,1,0,1,0
45641,443,12763,443,99276,88410,10866,143,333,78,65
39932,80,45032,80,3472,2124,1348,14,21,8,6
58646,44847,0,0,66,66,0,1,0,1,0
57438,53,26523,53,340,110,230,2,29,1,1
64237,53,49326,53,227,110,117,2,31,1,1
55600,22,0,0,60,60,0,1,0,1,0
40100,17,0,0,60,60,0,1,0,1,0
60797,445,0,0,70,70,0,1,0,1,0
27005,29999,13147,29999,876,126,750,2,31,1,1
2049,32480,0,0,62,62,0,1,0,1,0
60060,22,60060,22,7974,3469,4505,57,40,28,29
57689,445,0,0,66,66,0,1,0,1,0
56168,53,62337,53,745,93,652,2,30,1,1
62864,443,56821,443,86513,10300,76213,131,137,54,77
62273,50584,0,0,66,66,0,1,0,1,0
16387,26193,0,0,60,60,0,1,0,1,0
55132,445,0,0,70,70,0,1,0,1,0
49492,53,41002,53,199,102,97,2,31,1,1
49313,53,45650,53,199,102,97,2,30,1,1
49508,445,0,0,66,66,0,1,0,1,0
53826,10168,43672,10168,70,70,0,1,5,1,0
64914,53,55728,53,168,86,82,2,30,1,1
49996,80,14871,80,3007,604,2403,11,15,6,5
5588,5588,0,0,3498,1872,1626,48,201,24,24
49333,443,8337,443,50226,4284,45942,76,75,31,45
52989,51505,0,0,66,66,0,1,0,1,0
37845,443,37845,443,4441,1534,2907,19,25,11,8
7285,51221,0,0,66,66,0,1,0,1,0
14336,64147,0,0,62,62,0,1,0,1,0
50736,445,0,0,66,66,0,1,0,1,0
55943,53,5113,53,1415,94,1321,4,31,2,2
55117,443,14752,443,1350,689,661,14,18,8,6
57412,445,0,0,66,66,0,1,0,1,0
49732,53,17684,53,178,94,84,2,30,1,1
56658,53,56658,53,257,114,143,2,30,1,1
64084,445,0,0,70,70,0,1,0,1,0
50289,53,8502,53,189,102,87,2,30,1,1
32974,37965,0,0,66,66,0,1,0,1,0
56332,53,50254,53,186,95,91,2,30,1,1
1660,8696,0,0,62,62,0,1,0,1,0
48980,11119,0,0,146,146,0,1,0,1,0
49625,443,57635,443,4252,726,3526,13,16,7,6
64703,53,47599,53,306,142,164,2,30,1,1
57343,53,10133,53,214,86,128,2,29,1,1
53664,445,0,0,66,66,0,1,0,1,0
64467,80,64467,80,5570,699,4871,14,22,7,7
55442,53,12898,53,177,94,83,2,30,1,1
49432,445,0,0,70,70,0,1,0,1,0
64381,53,47350,53,196,100,96,2,30,1,1
52043,80,36469,80,4185,3462,723,14,15,7,7
34400,39004,0,0,74,74,0,1,0,1,0
48335,25174,0,0,62,62,0,1,0,1,0
50594,25174,0,0,66,66,0,1,0,1,0
64957,5555,0,0,60,60,0,1,0,1,0
57027,445,0,0,66,66,0,1,0,1,0
10874,25174,0,0,62,62,0,1,0,1,0
51628,443,16414,443,8084,2509,5575,36,195,19,17
38549,22114,0,0,62,62,0,1,0,1,0
56952,445,0,0,70,70,0,1,0,1,0
61937,443,25012,443,24420,19966,4454,64,136,35,29
52919,443,28761,443,7573,1986,5587,40,115,19,21
64214,445,0,0,66,66,0,1,0,1,0
55735,53,59032,53,256,93,163,2,30,1,1
50059,445,0,0,70,70,0,1,0,1,0
49846,80,38683,80,3215,2272,943,15,38,9,6
37330,53,37330,53,237,91,146,2,31,1,1
3478,61463,0,0,1188,1188,0,1,0,1,0
9457,443,13669,443,5316,488,4828,14,15,7,7
53828,443,58283,443,499,425,74,4,0,3,1
64516,53,8350,53,216,110,106,2,30,1,1
44173,53,9700,53,168,78,90,2,30,1,1
59597,37965,0,0,66,66,0,1,0,1,0
27005,1305,58083,1305,855,126,729,2,29,1,1
56798,443,60246,443,8073,2053,6020,20,15,11,9
56778,35292,48198,35292,70,70,0,1,5,1,0
50438,50584,0,0,146,146,0,1,0,1,0
59338,445,0,0,66,66,0,1,0,1,0
36836,443,63140,443,7195,1791,5404,18,99,11,7
58638,5900,0,0,62,62,0,1,0,1,0
54598,37965,0,0,62,62,0,1,0,1,0
50653,445,0,0,66,66,0,1,0,1,0
64813,445,0,0,70,70,0,1,0,1,0
53821,53,5224,53,199,94,105,2,30,1,1
51535,443,45578,443,202,70,132,3,11,1,2
39213,443,39213,443,4378,1471,2907,19,29,11,8
5894,44847,0,0,62,62,0,1,0,1,0
50313,53,2331,53,744,95,649,2,30,1,1
58638,5900,0,0,62,62,0,1,0,1,0
56450,53,63813,53,177,94,83,2,30,1,1
64493,53,56892,53,280,97,183,4,58,2,2
49658,443,50327,443,14121,2299,11822,37,19,19,18
9448,443,19728,443,5691,503,5188,14,15,7,7
60565,445,0,0,66,66,0,1,0,1,0
38427,443,30130,443,12591,2902,9689,40,55,19,21
32787,80,54491,80,1412,848,564,14,316,8,6
53853,443,28816,443,3692,2154,1538,25,81,12,13
60104,80,20513,80,18480,7940,10540,48,71,27,21
56550,53,19597,53,166,86,80,2,29,1,1
58763,53,58763,53,228,90,138,2,29,1,1
55588,53,17857,53,168,86,82,2,34,1,1
48844,443,50866,443,36383,29447,6936,103,163,51,52
443,46223,0,0,66,66,0,1,0,1,0
22528,25174,0,0,62,62,0,1,0,1,0
24270,53,24270,53,825,99,726,2,30,1,1
55082,445,0,0,66,66,0,1,0,1,0
56625,53,10109,53,711,87,624,2,31,1,1
38123,443,24032,443,15449,1976,13473,32,16,16,16
61533,445,0,0,70,70,0,1,0,1,0
64279,53,4406,53,177,94,83,2,30,1,1
51766,48169,62941,48169,70,70,0,2,7,2,0
64890,51180,0,0,66,66,0,1,0,1,0
58362,443,29130,443,13272,2360,10912,37,208,19,18
64125,53,26967,53,199,102,97,2,30,1,1
49899,443,2357,443,26284,21857,4427,72,83,39,33
52537,37965,0,0,66,66,0,1,0,1,0
62173,445,0,0,70,70,0,1,0,1,0
61669,445,0,0,70,70,0,1,0,1,0
35913,443,5129,443,14329,8250,6079,26,22,16,10
35626,22114,0,0,62,62,0,1,0,1,0
57044,53,24810,53,197,102,95,2,30,1,1
40204,40028,12239,40028,143,81,62,2,30,1,1
52251,80,52251,80,1838,1319,519,11,48,6,5
37427,443,48428,443,10281,4850,5431,23,400,13,10
52811,44847,0,0,66,66,0,1,0,1,0
62596,445,0,0,70,70,0,1,0,1,0
33044,443,11890,443,9695,5259,4436,24,35,12,12
63425,445,0,0,70,70,0,1,0,1,0
65286,445,0,0,70,70,0,1,0,1,0
27005,30015,42725,30015,1700,126,1574,4,31,2,2
30274,23,0,0,60,60,0,1,0,1,0
48758,443,1312,443,6353,1075,5278,18,33,10,8
51793,12210,25465,12210,70,70,0,1,5,1,0
40772,15503,0,0,74,74,0,1,0,1,0
55809,445,0,0,66,66,0,1,0,1,0
48817,57451,48817,57451,152,152,0,1,1200,1,0
56586,53,63496,53,177,94,83,2,31,1,1
50584,17991,30598,17991,161,161,0,2,1199,2,0
42854,443,46516,443,4268,2836,1432,25,19,13,12
65109,53,18311,53,753,94,659,2,30,1,1
50198,3389,50198,3389,3343,1454,1889,15,16,8,7
43260,41615,0,0,145,145,0,1,0,1,0
56976,80,37703,80,214,140,74,4,35,3,1
64059,80,17237,80,374,192,182,7,15,4,3
61616,445,0,0,70,70,0,1,0,1,0
58504,445,0,0,70,70,0,1,0,1,0
55816,53,60578,53,214,110,104,2,31,1,1
65356,53,60802,53,197,94,103,2,31,1,1
62388,39004,0,0,62,62,0,1,0,1,0
54280,3385,0,0,60,60,0,1,0,1,0
52782,443,35099,443,1581,924,657,15,125,7,8
52640,64147,0,0,62,62,0,1,0,1,0
50594,25174,0,0,66,66,0,1,0,1,0
56730,53,51057,53,733,86,647,2,30,1,1
58638,5900,0,0,62,62,0,1,0,1,0
53578,34129,19410,34129,70,70,0,1,5,1,0
56935,53,38764,53,179,94,85,2,30,1,1
27300,6881,0,0,62,62,0,1,0,1,0
56706,445,0,0,70,70,0,1,0,1,0
52522,80,14593,80,3290,2776,514,12,15,7,5
51834,80,36073,80,366,240,126,7,32,5,2
61978,445,0,0,70,70,0,1,0,1,0
56263,53,57350,53,385,134,251,2,31,1,1
59882,53,29947,53,244,86,158,2,29,1,1
41008,53,32302,53,168,78,90,2,29,1,1
60378,443,38205,443,130,70,60,2,15,1,1
52321,26467,0,0,62,62,0,1,0,1,0
54197,443,61116,443,190,70,120,4,15,2,2
43472,5228,13384,5228,2531,1416,1115,17,3600,8,9
33017,443,62492,443,11008,4624,6384,36,322,19,17
51117,60038,0,0,66,66,0,1,90,1,0
55645,445,0,0,70,70,0,1,0,1,0
28413,64147,0,0,66,66,0,1,0,1,0
55989,53,12782,53,821,102,719,2,30,1,1
49757,53,31813,53,177,94,83,2,31,1,1
123,123,41547,123,184,94,90,2,30,1,1
65226,445,0,0,70,70,0,1,0,1,0
37429,25174,0,0,62,62,0,1,0,1,0
58582,445,0,0,66,66,0,1,0,1,0
38885,21247,0,0,62,62,0,1,0,1,0
58906,443,27261,443,2896,1492,1404,17,17,9,8
62469,445,0,0,70,70,0,1,0,1,0
49753,80,62550,80,32910,18450,14460,143,1647,75,68
6666,6001,0,0,60,60,0,1,0,1,0
58924,443,40571,443,5168,700,4468,16,15,7,9
52018,2425,15478,2425,70,70,0,2,9,2,0
65185,27126,57830,27126,268,78,190,2,30,1,1
24504,37965,0,0,62,62,0,1,0,1,0
49207,58751,38431,58751,70,70,0,1,5,1,0
57197,445,0,0,70,70,0,1,0,1,0
37579,443,43995,443,499,425,74,4,0,3,1
65159,53,15273,53,286,103,183,4,52,2,2
57001,53,34470,53,210,110,100,2,30,1,1
49777,443,39129,443,8638,2215,6423,24,126,14,10
2422,62507,0,0,66,66,0,1,0,1,0
39313,37965,0,0,62,62,0,1,0,1,0
18683,26467,0,0,62,62,0,1,0,1,0
50680,445,0,0,66,66,0,1,0,1,0
53184,443,16399,443,13515,3057,10458,40,21,20,20
7524,23,0,0,60,60,0,1,0,1,0
55813,443,20333,443,15097,2888,12209,40,28,20,20
41882,443,10450,443,7218,4166,3052,38,133,19,19
59773,445,0,0,66,66,0,1,0,1,0
34531,80,18192,80,467664,17895,449769,610,355,265,345
49808,445,0,0,70,70,0,1,0,1,0
55374,445,0,0,70,70,0,1,0,1,0
49302,53,61464,53,234,94,140,2,30,1,1
9138,80,8999,80,318,192,126,6,29,4,2
64698,53,34866,53,211,102,109,2,30,1,1
63939,24867,28601,24867,312,132,180,6,6,3,3
51148,9571,0,0,66,66,0,1,0,1,0
39186,53,39186,53,371,237,134,3,33,2,1
56648,53,49574,53,199,102,97,2,30,1,1
54789,445,0,0,70,70,0,1,0,1,0
65530,53,49940,53,96,96,0,1,30,1,0
56613,443,6770,443,6016,1284,4732,18,984,8,10
5180,57866,0,0,62,62,0,1,0,1,0
49558,53,18984,53,177,94,83,2,30,1,1
35050,80,51635,80,350,210,140,6,30,4,2
55866,53,0,0,86,86,0,1,30,1,0
56981,443,53338,443,7238,2601,4637,20,22,10,10
22390,19473,0,0,66,66,0,1,0,1,0
64246,445,0,0,66,66,0,1,0,1,0
2791,7302,0,0,62,62,0,1,0,1,0
62910,993,51747,993,9108,4045,5063,84,72,39,45
56801,21916,14491,21916,316,136,180,6,7,3,3
48360,3389,48360,3389,4085,1916,2169,21,19,12,9
40549,443,43115,443,1352,691,661,14,42,8,6
57907,53,57907,53,228,97,131,2,31,1,1
50639,445,0,0,70,70,0,1,0,1,0
20898,53,20898,53,233,90,143,2,32,1,1
27005,27015,49083,27015,872,126,746,2,30,1,1
53694,8999,50905,8999,1179,606,573,12,17,7,5
7347,56205,0,0,66,66,0,1,0,1,0
53502,443,33693,443,10893,6516,4377,36,131,16,20
56669,445,0,0,70,70,0,1,0,1,0
55387,443,54944,443,3997,1374,2623,14,136,7,7
65284,445,0,0,70,70,0,1,0,1,0
53721,8999,32848,8999,320,140,180,6,6,3,3
58934,445,0,0,70,70,0,1,0,1,0
56873,53,29966,53,184,94,90,2,30,1,1
65200,51050,0,0,66,66,0,1,0,1,0
59065,443,57168,443,25840,18434,7406,45,171,26,19
58888,445,0,0,70,70,0,1,0,1,0
64968,53,62769,53,767,102,665,2,30,1,1
53917,80,62681,80,1829,755,1074,10,15,6,4
16387,16862,0,0,60,60,0,1,0,1,0
52165,445,0,0,70,70,0,1,0,1,0
48676,53395,0,0,60,60,0,1,0,1,0
9521,443,4635,443,7231,1442,5789,21,30,10,11
6224,37965,0,0,62,62,0,1,0,1,0
57456,443,62626,443,6350,1550,4800,23,41,12,11
55950,445,0,0,70,70,0,1,0,1,0
36566,37965,0,0,62,62,0,1,0,1,0
57553,443,21487,443,7075,2575,4500,21,30,12,9
60594,445,0,0,70,70,0,1,0,1,0
58958,445,0,0,70,70,0,1,0,1,0
13188,35440,0,0,66,66,0,1,0,1,0
54061,445,0,0,66,66,0,1,0,1,0
62554,445,0,0,70,70,0,1,0,1,0
46726,53,27470,53,168,78,90,2,30,1,1
52096,55854,62191,55854,70,70,0,1,5,1,0
65439,53,2036,53,168,86,82,2,29,1,1
35957,51185,0,0,60,60,0,1,0,1,0
57395,53,14755,53,262,88,174,4,59,2,2
56310,445,0,0,70,70,0,1,0,1,0
43597,443,44647,443,47048,9293,37755,63,412,28,35
3478,61463,0,0,933,933,0,1,0,1,0
39108,443,16198,443,330651,13398,317253,404,115,179,225
56771,53,26482,53,166,86,80,2,30,1,1
11350,3389,11350,3389,3850,1745,2105,19,18,11,8
10494,23,0,0,60,60,0,1,0,1,0
60755,443,57914,443,61151,2474,58677,61,25,16,45
60128,22114,0,0,62,62,0,1,0,1,0
64344,445,0,0,66,66,0,1,0,1,0
40474,23117,0,0,62,62,0,1,0,1,0
55292,53,33154,53,211,102,109,2,31,1,1
52772,445,0,0,70,70,0,1,0,1,0
53140,51221,0,0,74,74,0,1,0,1,0
56869,17637,0,0,66,66,0,1,0,1,0
7889,48817,0,0,146,146,0,1,0,1,0
36535,443,34984,443,3319,2176,1143,21,15,11,10
57451,443,58507,443,19175423,168230,19007193,15129,313,2298,12831
65048,53,15306,53,297,96,201,4,42,2,2
50581,445,0,0,66,66,0,1,0,1,0
51975,80,44833,80,426,240,186,8,25,5,3
35194,57470,0,0,74,74,0,1,0,1,0
27005,27016,57447,27016,885,126,759,2,30,1,1
53739,27290,28914,27290,70,70,0,1,4,1,0
64801,7000,64801,7000,2269,815,1454,14,15,7,7
41653,21247,0,0,62,62,0,1,0,1,0
13371,2323,13371,2323,124,60,64,2,5,1,1
58562,57587,0,0,66,66,0,1,0,1,0
12162,53,12162,53,233,90,143,2,33,1,1
58950,445,0,0,70,70,0,1,0,1,0
61074,445,0,0,70,70,0,1,0,1,0
51835,443,47905,443,546,300,246,10,31,6,4
0,0,0,0,480,244,236,4,0,2,2
54320,27016,28839,27016,924,924,0,3,30,3,0
65140,53,46396,53,199,102,97,2,29,1,1
60478,30889,28285,30889,1303,903,400,12,16,7,5
46324,443,40837,443,24465,3945,20520,39,18,18,21
33893,443,60654,443,8623,1758,6865,36,28,17,19
58026,80,26240,80,454,262,192,8,21,5,3
55072,445,0,0,70,70,0,1,0,1,0
64900,445,0,0,70,70,0,1,0,1,0
56946,445,0,0,66,66,0,1,0,1,0
50407,80,54250,80,1388,917,471,11,26,6,5
55055,445,0,0,70,70,0,1,0,1,0
53006,443,3727,443,2651,1504,1147,24,68,13,11
55423,53,31871,53,177,94,83,2,31,1,1
55520,445,0,0,70,70,0,1,0,1,0
58638,5900,0,0,62,62,0,1,0,1,0
54191,445,0,0,66,66,0,1,0,1,0
3341,23117,0,0,62,62,0,1,0,1,0
49334,53,44213,53,194,102,92,2,31,1,1
50597,443,31048,443,8031,1915,6116,24,17,12,12
52058,8329,19334,8329,70,70,0,2,9,2,0
56137,53,23667,53,199,102,97,2,31,1,1
52191,32843,31336,32843,70,70,0,1,4,1,0
55820,53,12238,53,184,94,90,2,30,1,1
46028,80,31228,80,1176793,65077,1111716,1528,85,788,740
59088,445,0,0,66,66,0,1,0,1,0
53795,22719,37217,22719,258,70,188,4,8,2,2
24208,53,24208,53,231,88,143,2,32,1,1
37428,53,37182,53,168,78,90,2,30,1,1
58042,80,52870,80,318,192,126,6,20,4,2
40358,53,40358,53,414,268,146,3,32,2,1
25653,26296,0,0,148,148,0,1,0,1,0
52513,80,64881,80,39793,2026,37767,55,16,27,28
8191,51221,0,0,62,62,0,1,0,1,0
6666,62078,0,0,60,60,0,1,0,1,0
63047,445,0,0,70,70,0,1,0,1,0
53862,36120,51667,36120,2254,1281,973,17,17,10,7
50208,445,0,0,66,66,0,1,0,1,0
55836,53,27528,53,181,94,87,2,30,1,1
49934,445,0,0,70,70,0,1,0,1,0
64934,53,9879,53,216,94,122,2,30,1,1
55575,31948,50458,31948,70,70,0,1,5,1,0
9277,443,3010,443,4230,760,3470,14,27,8,6
55820,53,19644,53,194,102,92,2,30,1,1
63379,36237,0,0,66,66,0,1,0,1,0
64795,445,0,0,70,70,0,1,0,1,0
52386,445,0,0,70,70,0,1,0,1,0
46410,80,31458,80,1163,705,458,10,15,6,4
44784,443,49876,443,12834,7868,4966,60,463,38,22
6881,6881,6157,6881,253,118,135,2,1200,1,1
57136,53,22982,53,209,110,99,2,30,1,1
50693,443,1637,443,306,120,186,6,23,3,3
123,123,46819,123,184,94,90,2,29,1,1
64921,53,46383,53,238,102,136,2,31,1,1
57196,53,50893,53,182,93,89,2,30,1,1
38056,443,15075,443,9528,2738,6790,27,81,15,12
51910,60443,42638,60443,66,66,0,1,5,1,0
49113,50584,0,0,62,62,0,1,0,1,0
19573,53,49198,53,183,78,105,2,30,1,1
59610,51505,0,0,66,66,0,1,0,1,0
5223,7851,0,0,66,66,0,1,0,1,0
57983,443,8445,443,315701,12378,303323,358,137,129,229
39207,80,48256,80,234,234,0,4,12,4,0
61740,443,10410,443,9854,2716,7138,36,49,20,16
40709,53,32661,53,221,75,146,2,30,1,1
45268,443,29338,443,7503,2345,5158,34,256,17,17
56127,37965,0,0,66,66,0,1,0,1,0
56919,53,40423,53,177,94,83,2,29,1,1
52483,1433,0,0,60,60,0,1,0,1,0
33457,27015,0,0,67,67,0,1,0,1,0
53300,37807,0,0,66,66,0,1,0,1,0
55225,11392,0,0,66,66,0,1,0,1,0
37555,16385,34137,16385,130,70,60,2,30,1,1
56499,445,0,0,66,66,0,1,0,1,0
61566,44847,0,0,66,66,0,1,0,1,0
60303,445,0,0,70,70,0,1,0,1,0
39617,50584,0,0,146,146,0,1,0,1,0
50169,445,0,0,70,70,0,1,0,1,0
58631,445,0,0,70,70,0,1,0,1,0
65259,37965,0,0,66,66,0,1,0,1,0
64810,53,30848,53,257,126,131,2,30,1,1
38515,443,54100,443,12624,5203,7421,48,274,24,24
58638,5900,0,0,62,62,0,1,0,1,0
50100,445,0,0,70,70,0,1,0,1,0
59044,53,47816,53,78,78,0,1,30,1,0
59361,445,0,0,70,70,0,1,0,1,0
49722,53,64718,53,200,102,98,2,29,1,1
45846,443,37447,443,4819,829,3990,15,40,8,7
43495,5223,36493,5223,142,142,0,1,4,1,0
62523,445,0,0,70,70,0,1,0,1,0
46746,443,33868,443,7002,4142,2860,46,1485,29,17
0,0,0,0,156,156,0,2,0,2,0
60904,443,17681,443,2356,1309,1047,16,31,9,7
46129,443,13770,443,6255,1125,5130,26,413,9,17
20682,57470,0,0,62,62,0,1,0,1,0
64180,445,0,0,70,70,0,1,0,1,0
55735,53,42351,53,199,102,97,2,30,1,1
57408,53,58813,53,190,97,93,2,30,1,1
58922,57470,0,0,66,66,0,1,0,1,0
59470,443,18542,443,3726,688,3038,14,119,7,7
54306,445,0,0,70,70,0,1,0,1,0
40821,41615,0,0,157,157,0,1,0,1,0
50589,445,0,0,66,66,0,1,0,1,0
44131,443,6596,443,6582,1943,4639,14,122,7,7
2844,3389,2844,3389,4635,2460,2175,21,18,12,9
50602,26467,0,0,66,66,0,1,0,1,0
56655,53,60599,53,168,86,82,2,31,1,1
49825,445,0,0,66,66,0,1,0,1,0
61075,53,61075,53,244,98,146,2,32,1,1
60114,443,25008,443,268,120,148,5,10,3,2
49797,445,0,0,66,66,0,1,0,1,0
54163,443,60868,443,2430,1416,1014,18,34,9,9
64177,44847,0,0,62,62,0,1,0,1,0
55529,44847,0,0,66,66,0,1,0,1,0
55330,445,0,0,70,70,0,1,0,1,0
57356,53,7268,53,199,102,97,2,29,1,1
31066,57470,0,0,74,74,0,1,0,1,0
65269,53,18855,53,226,102,124,2,30,1,1
51463,53,6551,53,417,86,331,2,31,1,1
64790,443,36803,443,53280,3270,50010,78,142,31,47
50518,445,0,0,70,70,0,1,0,1,0
11295,40040,23656,40040,213,89,124,4,31,2,2
20004,48817,0,0,146,146,0,1,0,1,0
1238,51505,0,0,62,62,0,1,0,1,0
57333,443,55597,443,12837,1681,11156,30,62,16,14
48681,11392,0,0,146,146,0,1,0,1,0
50898,443,1887,443,6883,1378,5505,19,128,9,10
58638,5900,0,0,62,62,0,1,0,1,0
56387,53,8885,53,757,98,659,2,31,1,1
58638,5900,0,0,62,62,0,1,0,1,0
64033,445,0,0,66,66,0,1,0,1,0
54489,53,0,0,418,154,264,4,33,2,2
56998,53,58740,53,177,94,83,2,29,1,1
56209,445,0,0,70,70,0,1,0,1,0
54199,443,3753,443,26903,3579,23324,72,278,33,39
55646,14420,30714,14420,70,70,0,1,5,1,0
58638,5900,0,0,62,62,0,1,0,1,0
61110,445,0,0,66,66,0,1,0,1,0
65393,443,57467,443,5121,936,4185,17,27,9,8
56246,53,1913,53,209,110,99,2,30,1,1
51771,80,34714,80,76066,3663,72403,92,24,40,52
51579,443,8189,443,1522,1210,312,9,28,4,5
50361,445,0,0,70,70,0,1,0,1,0
46362,35440,0,0,66,66,0,1,0,1,0
62109,44847,0,0,66,66,0,1,0,1,0
55403,445,0,0,70,70,0,1,0,1,0
64874,445,0,0,70,70,0,1,0,1,0
54703,23,0,0,60,60,0,1,0,1,0
13917,18033,0,0,62,62,0,1,0,1,0
56376,80,29400,80,1635,945,690,15,72,8,7
55463,53,53091,53,216,110,106,2,31,1,1
53586,443,61806,443,8510,3207,5303,25,324,13,12
49848,53,31476,53,167,86,81,2,30,1,1
39583,37965,0,0,66,66,0,1,0,1,0
64550,445,0,0,66,66,0,1,0,1,0
3117,37965,0,0,62,62,0,1,0,1,0
64853,445,0,0,70,70,0,1,0,1,0
9430,443,49322,443,6094,771,5323,17,26,9,8
53061,445,0,0,70,70,0,1,0,1,0
49201,445,0,0,66,66,0,1,0,1,0
56522,53,65076,53,177,94,83,2,31,1,1
40893,123,36091,123,184,94,90,2,31,1,1
49199,53,34176,53,816,102,714,2,30,1,1
27005,30007,42736,30007,890,126,764,2,31,1,1
55620,53,11702,53,177,94,83,2,29,1,1
1024,64147,0,0,62,62,0,1,0,1,0
58174,443,55907,443,11141,2777,8364,33,58,14,19
49777,443,42531,443,35152,27056,8096,56,104,31,25
52786,445,0,0,66,66,0,1,0,1,0
62227,443,62227,443,197342,62255,135087,232,170,110,122
51882,15733,3672,15733,70,70,0,1,5,1,0
62119,53,18352,53,239,102,137,2,30,1,1
57001,53,25113,53,177,94,83,2,30,1,1
34953,443,6409,443,9415,3482,5933,57,16,29,28
64868,53,56069,53,216,102,114,2,30,1,1
63970,28423,20673,28423,564,382,182,9,15,6,3
49625,445,0,0,70,70,0,1,0,1,0
58868,443,25875,443,1826093,48237,1777856,1873,71,599,1274
30015,36237,0,0,66,66,0,1,0,1,0
48817,11602,48817,11602,152,152,0,1,1200,1,0
49566,443,36540,443,10225,5069,5156,30,106,17,13
44847,51572,8318,51572,509,150,359,2,1200,1,1
57464,443,33460,443,7715,1772,5943,25,275,13,12
60883,64147,0,0,70,70,0,1,0,1,0
63976,25725,20832,25725,66,66,0,1,5,1,0
51167,445,0,0,70,70,0,1,0,1,0
56335,445,0,0,70,70,0,1,0,1,0
63806,443,63806,443,4651,1744,2907,19,30,11,8
65437,53,6994,53,173,94,79,2,30,1,1
37965,31483,54456,31483,4530,2856,1674,62,2421,35,27
6881,6881,29502,6881,231,111,120,2,1200,1,1
54038,445,0,0,66,66,0,1,0,1,0
1865,25174,0,0,62,62,0,1,0,1,0
34932,38608,0,0,62,62,0,1,0,1,0
21759,51505,0,0,66,66,0,1,0,1,0
54818,3389,54818,3389,3409,1454,1955,16,16,8,8
59810,445,0,0,70,70,0,1,0,1,0
50327,445,0,0,70,70,0,1,0,1,0
39566,443,50145,443,9748,5209,4539,22,121,11,11
56385,445,0,0,66,66,0,1,0,1,0
38057,443,24418,443,9486,2668,6818,26,81,14,12
49515,53,61596,53,195,102,93,2,31,1,1
54590,443,20540,443,12094,4159,7935,21,135,10,11
61681,443,6029,443,5922,1917,4005,24,18,14,10
53668,50678,10621,50678,70,70,0,1,5,1,0
54882,445,0,0,70,70,0,1,0,1,0
59607,53,65103,53,209,102,107,2,30,1,1
57309,53,4070,53,197,102,95,2,30,1,1
40766,443,50985,443,1093,662,431,10,41,6,4
55024,445,0,0,70,70,0,1,0,1,0
59038,445,0,0,70,70,0,1,0,1,0
61911,15503,0,0,146,146,0,1,0,1,0
443,28417,0,0,82,82,0,1,0,1,0
58826,445,0,0,66,66,0,1,0,1,0
60382,62582,18649,62582,70,70,0,2,8,2,0
55676,445,0,0,70,70,0,1,0,1,0
58046,443,22923,443,1536,1089,447,11,56,7,4
48817,6884,48817,6884,328,152,176,2,1200,1,1
59345,445,0,0,70,70,0,1,0,1,0
63924,445,0,0,70,70,0,1,0,1,0
53701,445,0,0,70,70,0,1,0,1,0
49864,53,65077,53,212,102,110,2,30,1,1
14438,51505,0,0,146,146,0,1,0,1,0
54377,445,0,0,66,66,0,1,0,1,0
56149,80,45182,80,1286,403,883,16,400,4,12
64789,445,0,0,66,66,0,1,0,1,0
18653,42707,0,0,66,66,0,1,0,1,0
14343,6881,0,0,146,146,0,1,0,1,0
30960,45740,3924,45740,330,330,0,6,3609,6,0
43888,64147,0,0,62,62,0,1,0,1,0
63016,443,62521,443,303,85,218,2,31,1,1
53867,443,58511,443,499,425,74,4,1,3,1
53647,16194,65302,16194,70,70,0,2,8,2,0
47200,443,56772,443,11003,3821,7182,35,257,14,21
55487,445,0,0,70,70,0,1,0,1,0
16027,22,0,0,60,60,0,1,0,1,0
56380,445,0,0,70,70,0,1,0,1,0
33794,53,45704,53,168,78,90,2,29,1,1
53679,24300,62271,24300,1656,914,742,13,21,9,4
59829,445,0,0,70,70,0,1,0,1,0
55868,445,0,0,66,66,0,1,0,1,0
52058,8329,7251,8329,66,66,0,1,5,1,0
20576,37965,0,0,62,62,0,1,0,1,0
55008,443,6262,443,7679,2605,5074,26,45,15,11
33264,53,24560,53,164,78,86,2,30,1,1
0,0,0,0,156,156,0,2,0,2,0
53557,39731,46000,39731,70,70,0,2,8,2,0
51948,37965,0,0,62,62,0,1,0,1,0
49416,53,31346,53,177,94,83,2,31,1,1
0,0,0,0,98,98,0,1,0,1,0
54721,22114,0,0,62,62,0,1,0,1,0
55089,80,46073,80,1558,452,1106,11,15,6,5
54932,443,37338,443,84306,6712,77594,156,236,58,98
45706,443,50703,443,512213,34626,477587,741,147,283,458
56268,53,23212,53,210,102,108,2,30,1,1
55681,31948,14765,31948,70,70,0,1,5,1,0
56101,57470,0,0,66,66,0,1,0,1,0
61057,25174,0,0,62,62,0,1,0,1,0
64819,445,0,0,70,70,0,1,0,1,0
46576,23718,0,0,66,66,0,1,0,1,0
41906,80,41906,80,127215,3221,123994,137,3685,42,95
57334,443,4953,443,11347,2434,8913,28,62,15,13
50116,22,50116,22,184,120,64,4,10,3,1
46860,53,42204,53,447,101,346,4,29,2,2
60956,445,0,0,66,66,0,1,0,1,0
43345,443,34624,443,7767,1069,6698,23,3971,7,16
64460,53,62568,53,192,98,94,2,31,1,1
27005,27017,7414,27017,882,126,756,2,30,1,1
52907,445,0,0,70,70,0,1,0,1,0
55044,445,0,0,70,70,0,1,0,1,0
40808,53,41572,53,168,78,90,2,29,1,1
49676,53,36174,53,733,86,647,2,30,1,1
6676,63836,0,0,145,145,0,1,0,1,0
49296,53,53194,53,193,102,91,2,31,1,1
42298,25161,56288,25161,138,70,68,2,30,1,1
56046,445,0,0,66,66,0,1,0,1,0
55056,53,32343,53,177,94,83,2,31,1,1
55421,53,47278,53,200,102,98,2,30,1,1
5223,1210,0,0,103,103,0,1,0,1,0
65188,27126,32293,27126,268,78,190,2,29,1,1
56883,53,20999,53,184,94,90,2,30,1,1
20487,50584,0,0,62,62,0,1,0,1,0
57470,35667,24783,35667,132,132,0,3,1200,3,0
65453,445,0,0,66,66,0,1,0,1,0
60504,445,0,0,70,70,0,1,0,1,0
64069,443,44966,443,11223,3362,7861,62,280,27,35
58687,11392,0,0,62,62,0,1,0,1,0
50550,80,15717,80,374,192,182,7,26,4,3
60112,23,0,0,60,60,0,1,0,1,0
60338,443,20283,443,3648,2251,1397,28,89,16,12
9402,53,9402,53,237,91,146,2,32,1,1
64831,53,59275,53,216,110,106,2,30,1,1
22924,25174,0,0,62,62,0,1,0,1,0
55617,53,59978,53,194,102,92,2,30,1,1
55665,445,0,0,70,70,0,1,0,1,0
49538,80,51947,80,2050,1691,359,9,75,6,3
60661,445,0,0,70,70,0,1,0,1,0
52148,29104,12286,29104,70,70,0,2,8,2,0
56805,53,35322,53,172,88,84,2,30,1,1
15503,19168,41378,19168,481,150,331,2,1200,1,1
38383,51221,0,0,66,66,0,1,0,1,0
51829,46209,37314,46209,70,70,0,2,6,2,0
58638,5900,0,0,62,62,0,1,0,1,0
27005,27015,61856,27015,888,126,762,2,30,1,1
34715,443,46649,443,584,370,214,9,26,6,3
52340,445,0,0,66,66,0,1,0,1,0
56583,53,58946,53,177,94,83,2,31,1,1
47739,5228,19332,5228,2852,2143,709,16,121,8,8
53716,443,15837,443,70,70,0,1,5,1,0
60977,443,59690,443,275026,15030,259996,353,72,167,186
54134,64147,0,0,66,66,0,1,0,1,0
57339,50584,0,0,62,62,0,1,0,1,0
49622,50584,0,0,62,62,0,1,0,1,0
53992,445,0,0,66,66,0,1,0,1,0
57010,445,0,0,70,70,0,1,0,1,0
11754,25174,0,0,62,62,0,1,0,1,0
56917,53,8537,53,424,104,320,4,30,2,2
29623,37807,0,0,146,146,0,1,0,1,0
51226,7275,28428,7275,416,210,206,7,16,4,3
55147,53,9806,53,184,94,90,2,30,1,1
61345,21247,0,0,62,62,0,1,0,1,0
3478,61463,0,0,1094,1094,0,1,0,1,0
56697,443,20511,443,8007,1987,6020,20,15,11,9
63205,9571,0,0,66,66,0,1,0,1,0
49332,53,40502,53,281,98,183,4,57,2,2
59859,443,59054,443,27510,4470,23040,67,122,34,33
64808,62413,0,0,62,62,0,1,0,1,0
64483,53,26683,53,168,86,82,2,31,1,1
54316,445,0,0,70,70,0,1,0,1,0
7356,25174,0,0,66,66,0,1,0,1,0
64573,53,28615,53,380,110,270,2,30,1,1
60142,445,0,0,70,70,0,1,0,1,0
61336,61689,0,0,62,62,0,1,0,1,0
57283,64147,0,0,66,66,0,1,0,1,0
61611,445,0,0,70,70,0,1,0,1,0
64124,53,27285,53,294,93,201,4,42,2,2
58634,445,0,0,70,70,0,1,0,1,0
54600,6881,0,0,66,66,0,1,0,1,0
63108,443,56013,443,4609,2177,2432,11,120,6,5
61499,445,0,0,70,70,0,1,0,1,0
60419,61248,0,0,145,145,0,1,0,1,0
33461,443,33205,443,8366,3900,4466,19,120,10,9
55261,53,19627,53,173,94,79,2,30,1,1
61414,443,14574,443,5020,860,4160,18,28,9,9
22263,30188,0,0,66,66,0,1,0,1,0
35949,31573,0,0,146,146,0,1,0,1,0
62780,35440,0,0,66,66,0,1,0,1,0
29313,48817,0,0,145,145,0,1,0,1,0
64580,53,3526,53,180,94,86,2,30,1,1
63963,53,44790,53,212,102,110,2,30,1,1
58018,443,65091,443,8828,2193,6635,38,99,17,21
64394,445,0,0,70,70,0,1,0,1,0
56404,445,0,0,70,70,0,1,0,1,0
27005,33076,26025,33076,889,126,763,2,31,1,1
50393,8080,50393,8080,378,180,198,7,31,4,3
49723,443,17483,443,11181,3795,7386,50,20,23,27
49990,443,43414,443,622,210,412,10,21,4,6
51781,445,0,0,66,66,0,1,0,1,0
44334,26467,0,0,62,62,0,1,0,1,0
50960,80,58959,80,5533225,44880,5488345,4345,78,654,3691
65515,53,18245,53,195,102,93,2,31,1,1
64766,53,47744,53,214,110,104,2,29,1,1
56609,3389,56609,3389,3327,1438,1889,15,16,8,7
37299,443,19605,443,10790,5444,5346,21,122,10,11
56438,3389,56438,3389,3425,1470,1955,16,17,8,8
17750,39318,52655,39318,481,150,331,2,1200,1,1
64192,445,0,0,66,66,0,1,0,1,0
54998,53,35657,53,174,89,85,2,31,1,1
47632,25174,0,0,62,62,0,1,0,1,0
33215,37965,0,0,62,62,0,1,0,1,0
58996,443,63733,443,4979,1505,3474,21,40,11,10
51789,40800,21058,40800,70,70,0,2,8,2,0
56617,443,25954,443,7981,1961,6020,20,16,11,9
49501,443,9020,443,15456,2581,12875,28,31,10,18
64939,445,0,0,66,66,0,1,0,1,0
56373,53,9472,53,200,102,98,2,30,1,1
59180,445,0,0,66,66,0,1,0,1,0
58993,443,47340,443,6414,1614,4800,24,17,13,11
57793,37807,0,0,66,66,0,1,0,1,0
57434,50584,0,0,146,146,0,1,0,1,0
41462,443,21403,443,10331,2157,8174,37,137,18,19
55018,443,29845,443,7232,2925,4307,27,16,16,11
54981,445,0,0,70,70,0,1,0,1,0
63542,3389,63542,3389,3504,1790,1714,17,32,9,8
59845,15503,0,0,66,66,0,1,0,1,0
55023,53,43972,53,216,102,114,2,30,1,1
53278,443,20618,443,12634,1635,10999,26,322,11,15
15249,22114,0,0,62,62,0,1,0,1,0
64488,445,0,0,66,66,0,1,0,1,0
56424,53,24013,53,711,87,624,2,0,1,1
53185,443,52524,443,4442408,142153,4300255,4731,235,1574,3157
56060,53,26992,53,224,102,122,2,30,1,1
57006,53,13462,53,196,102,94,2,29,1,1
64677,53,58771,53,183,94,89,2,30,1,1
64882,53,2357,53,176,90,86,2,30,1,1
64727,25174,0,0,66,66,0,1,0,1,0
50584,54157,4800,54157,1377,300,1077,6,1200,3,3
33664,80,64127,80,3667,1654,2013,20,189,11,9
60674,8055,0,0,145,145,0,1,0,1,0
64506,53,36287,53,184,86,98,2,30,1,1
55542,445,0,0,70,70,0,1,0,1,0
55589,53,33223,53,177,94,83,2,29,1,1
64582,445,0,0,70,70,0,1,0,1,0
57880,443,33669,443,1868,1229,639,18,177,11,7
64689,53,18910,53,182,93,89,2,31,1,1
17982,11392,0,0,62,62,0,1,0,1,0
53640,443,55622,443,3201,1057,2144,13,135,6,7
50218,53,12883,53,165,86,79,2,29,1,1
49418,30010,58880,30010,238,71,167,2,30,1,1
58420,443,23233,443,17161,1619,15542,18,149,4,14
64036,23718,0,0,62,62,0,1,0,1,0
9687,57470,0,0,78,78,0,1,0,1,0
31609,25174,0,0,62,62,0,1,0,1,0
443,48346,0,0,81,81,0,1,0,1,0
7347,56205,0,0,62,62,0,1,0,1,0
51807,443,51807,443,1466,856,610,13,27,6,7
49275,7000,49275,7000,2163,676,1487,14,15,7,7
41395,443,34255,443,6292,1492,4800,22,17,11,11
56647,443,45722,443,8059,2039,6020,20,15,11,9
65443,80,29432,80,366,180,186,7,28,4,3
59204,443,10417,443,9335,3052,6283,25,125,11,14
51538,445,0,0,70,70,0,1,0,1,0
45355,443,7242,443,410,210,200,7,92,4,3
51869,443,60062,443,4435,1290,3145,17,31,9,8
57202,53,47171,53,184,94,90,2,30,1,1
59900,445,0,0,66,66,0,1,0,1,0
64586,80,64586,80,123115,6863,116252,160,29,76,84
30188,32873,43392,32873,502,150,352,2,1200,1,1
52213,80,42925,80,5022,1422,3600,16,135,8,8
6247,51221,0,0,78,78,0,1,0,1,0
10167,80,10167,80,450,246,204,8,25,5,3
46758,123,10814,123,184,94,90,2,30,1,1
59787,443,23637,443,276238,23971,252267,482,138,188,294
64573,53,37433,53,757,102,655,2,30,1,1
49524,443,52573,443,52864,3584,49280,86,95,39,47
49416,80,5310,80,318,192,126,6,28,4,2
32729,3389,32729,3389,4021,1916,2105,20,18,12,8
63885,445,0,0,66,66,0,1,0,1,0
58058,80,25761,80,318,192,126,6,21,4,2
54030,443,52354,443,249900,26024,223876,450,167,183,267
0,0,0,0,480,244,236,4,0,2,2
57339,53,58719,53,248,94,154,2,30,1,1
56973,443,43404,443,22953,5010,17943,38,123,14,24
65283,53,18469,53,732,89,643,2,30,1,1
37589,443,25099,443,499,425,74,4,0,3,1
54991,53,42971,53,253,87,166,4,29,2,2
9446,443,50836,443,8672,1863,6809,22,46,11,11
65204,53,43316,53,183,94,89,2,30,1,1
22587,30188,0,0,62,62,0,1,0,1,0
58638,5900,58638,5900,66,66,0,1,4,1,0
60059,53,45306,53,168,78,90,2,30,1,1
52641,445,0,0,70,70,0,1,0,1,0
64425,53,47922,53,216,94,122,2,30,1,1
65488,53,4906,53,232,110,122,2,29,1,1
51397,445,0,0,66,66,0,1,0,1,0
49741,80,28243,80,1149,412,737,8,17,5,3
47636,53,0,0,86,86,0,1,29,1,0
49520,445,0,0,70,70,0,1,0,1,0
56152,53,29649,53,195,102,93,2,30,1,1
50688,80,9336,80,27391,3550,23841,36,20,15,21
63328,445,0,0,66,66,0,1,0,1,0
6882,25021,51756,25021,509,150,359,2,1200,1,1
54114,445,0,0,70,70,0,1,0,1,0
56825,445,0,0,70,70,0,1,0,1,0
51389,445,0,0,66,66,0,1,0,1,0
53656,31573,0,0,66,66,0,1,0,1,0
56609,53,56720,53,198,101,97,2,30,1,1
42252,33303,0,0,60,60,0,1,0,1,0
14023,37965,0,0,62,62,0,1,0,1,0
50652,443,65076,443,2477,1505,972,15,20,9,6
64374,53,45440,53,239,102,137,2,30,1,1
51861,53,51861,53,305,160,145,3,33,2,1
42846,443,19024,443,162,102,60,2,5,1,1
12060,37965,0,0,66,66,0,1,0,1,0
56180,53,32734,53,200,102,98,2,31,1,1
56141,53,30553,53,184,94,90,2,30,1,1
27824,51505,0,0,62,62,0,1,0,1,0
49849,53,48086,53,325,126,199,2,30,1,1
28221,37965,0,0,62,62,0,1,0,1,0
37625,443,14545,443,7766,1810,5956,24,46,14,10
64216,53,64216,53,220,100,120,2,30,1,1
57322,445,0,0,70,70,0,1,0,1,0
54693,445,0,0,70,70,0,1,0,1,0
56071,53,41864,53,186,95,91,2,31,1,1
55872,445,0,0,70,70,0,1,0,1,0
64222,445,0,0,70,70,0,1,0,1,0
65067,53,58003,53,214,110,104,2,30,1,1
65114,443,65114,443,4480,1573,2907,19,30,11,8
56020,53,34140,53,199,102,97,2,29,1,1
30443,44847,0,0,62,62,0,1,0,1,0
49191,53,32868,53,186,95,91,2,31,1,1
49831,53,24463,53,364,102,262,2,30,1,1
27005,30002,50231,30002,1780,252,1528,5,44,3,2
55840,53,8081,53,177,94,83,2,30,1,1
50565,53,50708,53,707,94,613,2,30,1,1
59592,37965,0,0,62,62,0,1,0,1,0
52183,443,6084,443,10107,1324,8783,22,75,12,10
53291,445,0,0,70,70,0,1,0,1,0
6666,62078,0,0,60,60,0,1,0,1,0
60406,64337,21894,64337,70,70,0,1,5,1,0
40598,23,0,0,60,60,0,1,0,1,0
49903,445,0,0,66,66,0,1,0,1,0
46486,53,46486,53,414,268,146,3,34,2,1
63932,53,27137,53,179,94,85,2,30,1,1
50784,52952,0,0,62,62,0,1,0,1,0
49913,53,47185,53,216,110,106,2,30,1,1
63804,52520,44580,52520,66,66,0,1,5,1,0
56442,53,53594,53,167,86,81,2,30,1,1
47103,55378,0,0,146,146,0,1,0,1,0
9520,443,43478,443,3614,434,3180,11,15,6,5
57919,443,32808,443,21293,7315,13978,85,188,37,48
61574,445,0,0,70,70,0,1,0,1,0
56009,53,7541,53,172,88,84,2,31,1,1
57538,30188,0,0,66,66,0,1,0,1,0
64525,53,5631,53,199,102,97,2,29,1,1
50962,5900,0,0,60,60,0,1,0,1,0
64539,53,23141,53,712,214,498,6,44,3,3
58638,5900,0,0,62,62,0,1,0,1,0
48778,80,16126,80,130,70,60,2,15,1,1
56131,445,0,0,70,70,0,1,0,1,0
64012,40642,7765,40642,70,70,0,1,5,1,0
50026,53,4265,53,395,99,296,4,57,2,2
49522,21247,0,0,66,66,0,1,0,1,0
65153,53,31638,53,184,86,98,2,29,1,1
56370,443,46541,443,3715,1791,1924,23,203,12,11
6404,64147,0,0,145,145,0,1,0,1,0
5588,5588,0,0,3354,1792,1562,46,192,23,23
53886,443,40309,443,499,425,74,4,0,3,1
45813,5222,28803,5222,5723,3023,2700,58,548,32,26
60299,445,0,0,70,70,0,1,0,1,0
51062,1433,0,0,60,60,0,1,0,1,0
51738,445,0,0,70,70,0,1,0,1,0
56827,53,18397,53,195,102,93,2,30,1,1
56582,23718,0,0,66,66,0,1,0,1,0
24127,56205,0,0,66,66,0,1,0,1,0
57226,53,39140,53,178,94,84,2,31,1,1
65495,53,9784,53,202,103,99,2,31,1,1
54452,445,0,0,66,66,0,1,0,1,0
39473,443,25041,443,11226,3340,7886,28,16,16,12
55654,53,20360,53,726,85,641,2,31,1,1
19004,51505,0,0,66,66,0,1,0,1,0
8040,44847,0,0,66,66,0,1,0,1,0
49778,53,5798,53,319,98,221,4,53,2,2
35339,443,19701,443,6677,1006,5671,19,27,11,8
59575,445,0,0,70,70,0,1,0,1,0
49418,27015,47844,27015,214,71,143,2,30,1,1
61365,445,0,0,70,70,0,1,0,1,0
55610,53,5256,53,822,102,720,2,29,1,1
57311,443,59894,443,134,60,74,3,6,2,1
50067,445,0,0,70,70,0,1,0,1,0
49622,80,33304,80,454,262,192,8,42,5,3
45057,443,53651,443,1394,733,661,14,80,8,6
27005,27015,8192,27015,912,126,786,2,31,1,1
55464,22114,0,0,62,62,0,1,0,1,0
55605,53,59793,53,198,102,96,2,33,1,1
64249,445,0,0,70,70,0,1,0,1,0
60883,64147,0,0,74,74,0,1,0,1,0
34373,28678,41304,28678,1806,1806,0,22,224,22,0
49360,445,0,0,70,70,0,1,0,1,0
60261,25174,0,0,66,66,0,1,0,1,0
51817,54601,57265,54601,316,136,180,6,7,3,3
51745,57470,0,0,145,145,0,1,0,1,0
55179,53,7582,53,194,102,92,2,33,1,1
63972,53,35839,53,193,102,91,2,30,1,1
59592,37965,0,0,62,62,0,1,0,1,0
56063,53,65199,53,192,98,94,2,31,1,1
27005,27018,26444,27018,1634,126,1508,4,30,2,2
22408,22114,0,0,66,66,0,1,0,1,0
58638,5900,0,0,62,62,0,1,0,1,0
49177,53,40047,53,184,94,90,2,31,1,1
63902,445,0,0,70,70,0,1,0,1,0
50325,445,0,0,70,70,0,1,0,1,0
55395,445,0,0,70,70,0,1,0,1,0
64127,53,25934,53,177,94,83,2,30,1,1
45987,443,65054,443,3160640,65300,3095340,2786,144,547,2239
37965,51498,7708,51498,158,158,0,1,1199,1,0
56755,53,24589,53,184,94,90,2,30,1,1
49547,53,49951,53,193,102,91,2,30,1,1
57033,53,53118,53,216,110,106,2,30,1,1
61060,445,0,0,70,70,0,1,0,1,0
58943,443,29236,443,6611,4273,2338,22,17,11,11
4257,35440,0,0,62,62,0,1,0,1,0
64715,53,47413,53,209,110,99,2,30,1,1
50455,80,38947,80,4395,3599,796,15,34,8,7
48305,443,59833,443,572565,17274,555291,546,147,124,422
50047,445,0,0,66,66,0,1,0,1,0
56363,53,52930,53,212,102,110,2,30,1,1
5223,61002,0,0,161,161,0,1,0,1,0
49341,80,65147,80,1969,463,1506,13,55,7,6
15131,50584,0,0,62,62,0,1,0,1,0
54354,443,10906,443,18848,10436,8412,42,33,20,22
50265,24387,12796,24387,132,132,0,3,1200,3,0
54769,50584,0,0,146,146,0,1,0,1,0
65096,37807,0,0,62,62,0,1,0,1,0
64592,53,28124,53,197,94,103,2,30,1,1
64404,53,27516,53,250,102,148,2,30,1,1
443,18411,0,0,74,74,0,1,0,1,0
60305,80,11406,80,4419,3852,567,15,144,8,7
49418,30002,50815,30002,242,71,171,2,30,1,1
49450,443,10791,443,5792,1511,4281,19,77,11,8
62889,445,0,0,66,66,0,1,0,1,0
57170,53,47776,53,200,102,98,2,30,1,1
57470,43836,52896,43836,402,132,270,6,1209,3,3
54586,445,0,0,66,66,0,1,0,1,0
50724,443,48529,443,12515,5891,6624,42,166,22,20
58638,5900,0,0,62,62,0,1,0,1,0
38715,443,52129,443,403299,12717,390582,439,16,171,268
49675,53,62598,53,199,102,97,2,29,1,1
57985,443,21475,443,140109,5229,134880,159,46,59,100
64934,445,0,0,66,66,0,1,0,1,0
33305,54532,0,0,60,60,0,1,0,1,0
64988,27052,9710,27052,735,462,273,2,31,1,1
36828,80,12290,80,5189,2979,2210,19,136,12,7
6416,22114,0,0,66,66,0,1,0,1,0
34400,39004,0,0,74,74,0,1,0,1,0
53199,443,19271,443,1582,965,617,15,18,7,8
57652,445,0,0,66,66,0,1,0,1,0
58638,5900,0,0,62,62,0,1,0,1,0
61834,443,61834,443,220115,6038,214077,231,76,78,153
51723,10622,43836,10622,70,70,0,2,8,2,0
64475,53,57543,53,314,99,215,4,39,2,2
56684,443,53117,443,7907,1918,5989,20,15,11,9
64028,53,51007,53,293,134,159,2,30,1,1
51289,445,0,0,70,70,0,1,0,1,0
64562,53,22327,53,371,94,277,2,30,1,1
37633,443,4674,443,8493,2314,6179,33,16,18,15
27005,27015,55058,27015,1666,126,1540,4,31,2,2
53832,56005,63005,56005,70,70,0,1,4,1,0
52185,13269,32926,13269,70,70,0,2,7,2,0
53134,42369,45499,42369,70,70,0,2,8,2,0
56120,53,36940,53,212,102,110,2,30,1,1
63590,445,0,0,66,66,0,1,0,1,0
58789,443,17140,443,14261,9361,4900,35,16,19,16
50672,445,0,0,66,66,0,1,0,1,0
60186,445,0,0,70,70,0,1,0,1,0
59488,443,37367,443,6100,580,5520,17,53,5,12
52082,14804,24933,14804,70,70,0,1,4,1,0
9687,57470,0,0,78,78,0,1,0,1,0
63617,445,0,0,70,70,0,1,0,1,0
35229,32468,0,0,62,62,0,1,0,1,0
57108,53,22880,53,186,95,91,2,30,1,1
27064,51221,0,0,72,72,0,1,0,1,0
7246,59858,0,0,66,66,0,1,0,1,0
55392,53,63211,53,418,94,324,2,30,1,1
56666,445,0,0,70,70,0,1,0,1,0
443,35385,0,0,130,130,0,1,0,1,0
53519,64147,0,0,66,66,0,1,0,1,0
62360,445,0,0,66,66,0,1,0,1,0
4515,37807,0,0,62,62,0,1,0,1,0
53650,64147,0,0,66,66,0,1,0,1,0
50698,443,13372,443,24575,6565,18010,86,275,32,54
61453,443,29702,443,8052,1307,6745,27,125,16,11
37483,443,13150,443,70,70,0,2,5,2,0
58704,80,26628,80,4115,3452,663,13,15,7,6
56778,445,0,0,66,66,0,1,0,1,0
54894,445,0,0,70,70,0,1,0,1,0
35549,443,45483,443,9032,2244,6788,36,255,17,19
50853,50584,0,0,66,66,0,1,0,1,0
14923,51505,0,0,66,66,0,1,0,1,0
64351,445,0,0,70,70,0,1,0,1,0
49516,80,21754,80,1256,746,510,11,70,6,5
60409,80,41783,80,10970,7709,3261,24,29,13,11
11136,57587,0,0,62,62,0,1,0,1,0
48631,443,20403,443,42910,5005,37905,72,136,36,36
55883,445,0,0,70,70,0,1,0,1,0
60684,80,43634,80,1737,796,941,12,16,7,5
54377,56205,0,0,66,66,0,1,0,1,0
50613,445,0,0,70,70,0,1,0,1,0
47643,80,39174,80,3524,2698,826,14,16,8,6
49470,445,0,0,66,66,0,1,0,1,0
55551,445,0,0,66,66,0,1,0,1,0
58606,445,0,0,70,70,0,1,0,1,0
62414,50584,0,0,66,66,0,1,0,1,0
46409,35440,0,0,62,62,0,1,0,1,0
59766,53,33803,53,512,166,346,2,30,1,1
23873,30188,0,0,66,66,0,1,0,1,0
50803,443,27237,443,25297,10467,14830,51,362,27,24
9154,443,7257,443,6258,843,5415,19,29,10,9
49820,53,34423,53,193,102,91,2,30,1,1
62275,443,20241,443,18482489,568378,17914111,19386,214,6466,12920
56145,445,0,0,70,70,0,1,0,1,0
65132,445,0,0,66,66,0,1,0,1,0
34597,80,9526,80,1540,553,987,10,15,6,4
62340,445,0,0,70,70,0,1,0,1,0
56906,443,9378,443,1712418,88847,1623571,2014,149,715,1299
33000,53,0,0,82,82,0,1,31,1,0
50686,443,29049,443,6340,1381,4959,19,170,9,10
57073,443,48824,443,7731,2016,5715,38,271,20,18
65180,53,33252,53,751,95,656,2,30,1,1
39496,80,39496,80,2898,1485,1413,10,15,6,4
7482,57470,0,0,66,66,0,1,0,1,0
55373,1,0,0,66,66,0,1,0,1,0
50995,53,51013,53,168,78,90,2,30,1,1
55237,53,24870,53,259,87,172,4,56,2,2
55937,53,58356,53,179,94,85,2,30,1,1
60297,80,29320,80,1463,865,598,11,144,6,5
42298,40015,12335,40015,140,78,62,2,31,1,1
55689,37965,0,0,66,66,0,1,0,1,0
57200,53,22685,53,770,102,668,2,31,1,1
14023,37965,0,0,62,62,0,1,0,1,0
54647,445,0,0,70,70,0,1,0,1,0
55463,53,21645,53,216,110,106,2,30,1,1
59297,80,59297,80,107500,4003,103497,173,16,57,116
49393,445,0,0,70,70,0,1,0,1,0
57564,56205,0,0,62,62,0,1,0,1,0
55485,445,0,0,70,70,0,1,0,1,0
55514,53,44502,53,783,96,687,2,30,1,1
6778,50584,0,0,66,66,0,1,0,1,0
60239,445,0,0,66,66,0,1,0,1,0
45682,37965,0,0,145,145,0,1,0,1,0
55733,445,0,0,66,66,0,1,0,1,0
49608,53,36244,53,177,94,83,2,31,1,1
65246,53,1802,53,209,102,107,2,30,1,1
49724,53,47705,53,183,94,89,2,30,1,1
10436,53,10436,53,237,91,146,2,32,1,1
54811,443,21381,443,3392,2305,1087,22,80,11,11
6881,6881,0,0,146,146,0,1,0,1,0
65226,53,19267,53,79,79,0,2,34,2,0
51988,32239,13198,32239,66,66,0,1,5,1,0
49790,53,34832,53,195,102,93,2,30,1,1
2531,30188,0,0,66,66,0,1,0,1,0
55791,445,0,0,70,70,0,1,0,1,0
40273,53,38821,53,164,78,86,2,30,1,1
56661,443,57675,443,334,70,264,5,17,1,4
29363,443,29363,443,29861,6027,23834,65,37,34,31
57902,443,7313,443,1912,1213,699,19,169,11,8
51525,35440,0,0,66,66,0,1,0,1,0
50478,51505,0,0,66,66,0,1,0,1,0
64184,443,64184,443,4561,1654,2907,19,28,11,8
54051,28793,0,0,66,66,0,1,0,1,0
62781,445,0,0,66,66,0,1,0,1,0
56864,445,0,0,70,70,0,1,0,1,0
49418,27015,32130,27015,260,78,182,2,30,1,1
62811,445,0,0,66,66,0,1,0,1,0
37028,51505,0,0,62,62,0,1,0,1,0
52277,445,0,0,70,70,0,1,0,1,0
18653,42707,0,0,66,66,0,1,0,1,0
443,20995,0,0,83,83,0,1,0,1,0
53173,25067,40514,25067,70,70,0,1,5,1,0
55101,445,0,0,70,70,0,1,0,1,0
44538,50584,0,0,62,62,0,1,0,1,0
55542,53,5269,53,711,87,624,2,31,1,1
63818,19291,56455,19291,66,66,0,2,7,2,0
42895,443,18411,443,600,156,444,8,25,2,6
50387,8080,50387,8080,7241,3224,4017,23,61,14,9
54737,50584,0,0,66,66,0,1,0,1,0
12644,11392,0,0,66,66,0,1,0,1,0
63398,25174,0,0,66,66,0,1,0,1,0
37576,443,21717,443,11777,4005,7772,35,44,15,20
43747,22114,0,0,62,62,0,1,0,1,0
55155,53,64785,53,183,94,89,2,29,1,1
56629,443,36618,443,22938,14436,8502,43,35,23,20
26697,37965,0,0,66,66,0,1,0,1,0
41943,443,27053,443,8385,3143,5242,35,98,18,17
55236,53,12241,53,819,102,717,2,29,1,1
5357,32468,0,0,62,62,0,1,0,1,0
54939,443,24418,443,13018,3066,9952,65,361,33,32
56654,53,47578,53,102,102,0,1,30,1,0
58638,5900,58638,5900,156,62,94,2,10,1,1
49484,80,60761,80,318,192,126,6,39,4,2
11133,51505,0,0,66,66,0,1,0,1,0
50400,53,28411,53,177,94,83,2,30,1,1
62305,445,0,0,70,70,0,1,0,1,0
19204,41864,0,0,159,159,0,1,0,1,0
45169,14037,0,0,74,74,0,1,0,1,0
7067,22114,0,0,146,146,0,1,0,1,0
64869,53,31516,53,195,94,101,2,30,1,1
56367,53,12261,53,900,110,790,2,29,1,1
27005,27015,64723,27015,901,126,775,2,30,1,1
50977,80,13754,80,45483,4137,41346,68,21,36,32
2885,443,2885,443,28717,3437,25280,45,23,23,22
58894,443,36068,443,5168,700,4468,16,15,7,9
57745,445,0,0,70,70,0,1,0,1,0
44037,5223,40215,5223,5096,1030,4066,25,1751,9,16
36313,443,38446,443,55608,48375,7233,140,95,81,59
62610,445,0,0,70,70,0,1,0,1,0
9172,443,4913,443,89362,3092,86270,100,21,37,63
55656,53,20503,53,760,96,664,2,30,1,1
60932,445,0,0,70,70,0,1,0,1,0
49418,12345,11846,12345,249,71,178,2,30,1,1
57398,443,53104,443,1056,569,487,10,24,6,4
56149,53,1500,53,179,94,85,2,30,1,1
50584,6882,59204,6882,371,311,60,4,1199,3,1
49174,53,10035,53,264,110,154,2,30,1,1
40738,443,14631,443,1656,114,1542,5,120,2,3
61589,21247,0,0,66,66,0,1,0,1,0
56576,445,0,0,66,66,0,1,0,1,0
3478,61463,0,0,252,252,0,1,0,1,0
60222,443,32889,443,12428,5331,7097,47,32,21,26
65382,445,0,0,70,70,0,1,0,1,0
55862,445,0,0,70,70,0,1,0,1,0
51788,445,0,0,66,66,0,1,0,1,0
49436,53,61599,53,718,94,624,2,30,1,1
64706,443,64706,443,274,132,142,5,76,3,2
44388,63874,0,0,62,62,0,1,0,1,0
50134,53,12196,53,768,99,669,2,30,1,1
55294,53,35326,53,199,102,97,2,30,1,1
47814,51505,0,0,62,62,0,1,0,1,0
52100,443,14481,443,7711,1717,5994,26,361,13,13
64309,53,55479,53,549,188,361,6,57,3,3
55315,53,41500,53,192,98,94,2,31,1,1
57828,445,0,0,70,70,0,1,0,1,0
62150,23718,0,0,66,66,0,1,0,1,0
57266,53,10699,53,753,96,657,2,31,1,1
60419,445,0,0,66,66,0,1,0,1,0
42285,57470,0,0,62,62,0,1,0,1,0
54122,443,54122,443,186718,24971,161747,253,84,127,126
61459,445,0,0,70,70,0,1,0,1,0
56883,53,10133,53,184,94,90,2,30,1,1
56620,53,63507,53,216,110,106,2,30,1,1
49445,445,0,0,70,70,0,1,0,1,0
10166,44847,0,0,62,62,0,1,0,1,0
47910,7454,0,0,60,60,0,1,0,1,0
37965,32305,6845,32305,1650,1650,0,26,1537,26,0
27005,1303,22373,1303,868,126,742,2,30,1,1
55776,53,26753,53,271,93,178,4,30,2,2
49713,53,39823,53,184,94,90,2,30,1,1
57139,53,1323,53,164,84,80,2,31,1,1
46409,80,63158,80,1053,613,440,10,15,5,5
56880,53,14600,53,216,102,114,2,30,1,1
35336,443,36436,443,6821,1076,5745,21,27,12,9
49704,80,31664,80,217502,6597,210905,211,109,62,149
50339,445,0,0,66,66,0,1,0,1,0
40893,443,32829,443,10450,3898,6552,20,135,11,9
27005,27016,31585,27016,876,126,750,2,30,1,1
64003,38926,33075,38926,66,66,0,2,8,2,0
58638,5900,0,0,62,62,0,1,0,1,0
1384,44847,0,0,66,66,0,1,0,1,0
20341,53,20341,53,225,90,135,2,30,1,1
64454,53,61289,53,293,110,183,2,29,1,1
46640,8880,0,0,60,60,0,1,0,1,0
33896,57470,0,0,74,74,0,1,0,1,0
51789,445,0,0,70,70,0,1,0,1,0
65468,53,8938,53,200,94,106,2,30,1,1
47050,443,20550,443,10868,2200,8668,32,44,14,18
56964,53,11967,53,774,101,673,2,31,1,1
45564,443,3708,443,69614,5520,64094,100,21,52,48
34400,39004,0,0,74,74,0,1,0,1,0
61363,445,0,0,66,66,0,1,0,1,0
62878,445,0,0,70,70,0,1,0,1,0
51842,27665,50059,27665,70,70,0,1,5,1,0
50734,443,16701,443,1726,668,1058,13,2033,4,9
55018,53,64174,53,312,89,223,4,36,2,2
57385,53,7964,53,197,102,95,2,30,1,1
45313,64147,0,0,62,62,0,1,0,1,0
52990,445,0,0,70,70,0,1,0,1,0
58638,5900,0,0,62,62,0,1,0,1,0
10736,35440,0,0,62,62,0,1,0,1,0
52342,445,0,0,66,66,0,1,0,1,0
57605,80,57605,80,36471,5174,31297,57,38,23,34
60000,443,63999,443,1641,730,911,14,18,8,6
50647,445,0,0,66,66,0,1,0,1,0
49777,53,60241,53,272,84,188,4,60,2,2
49767,53,47243,53,185,102,83,2,30,1,1
54969,53,41747,53,199,102,97,2,29,1,1
58509,21247,0,0,66,66,0,1,0,1,0
33886,65504,0,0,162,162,0,1,0,1,0
55199,53,53506,53,214,110,104,2,31,1,1
35722,30188,0,0,62,62,0,1,0,1,0
25067,50265,0,0,145,145,0,1,0,1,0
58638,5900,0,0,62,62,0,1,0,1,0
51840,34678,2661,34678,70,70,0,2,8,2,0
50649,80,63151,80,1366,865,501,8,15,5,3
40906,8434,40906,8434,156,156,0,3,8,3,0
33383,443,13969,443,24440,2215,22225,46,316,20,26
64578,53,31792,53,193,102,91,2,31,1,1
50930,443,54294,443,134,60,74,3,10,2,1
65266,53,28016,53,536,113,423,4,56,2,2
50287,53,28262,53,781,94,687,2,30,1,1
55431,53,28791,53,192,98,94,2,30,1,1
26900,27017,23576,27017,340,82,258,5,29,2,3
3436,46783,0,0,62,62,0,1,0,1,0
9506,2323,0,0,60,60,0,1,0,1,0
60950,443,63675,443,7431,2753,4678,40,18,21,19
65506,53,15371,53,197,102,95,2,30,1,1
58646,445,0,0,70,70,0,1,0,1,0
55981,53,55529,53,168,78,90,2,30,1,1
54028,37965,0,0,66,66,0,1,0,1,0
34979,80,8756,80,1150,465,685,14,268,5,9
54979,53,11444,53,183,94,89,2,30,1,1
17750,60780,57502,60780,481,150,331,2,1200,1,1
64281,53,45768,53,214,110,104,2,31,1,1
64723,56205,0,0,62,62,0,1,0,1,0
60129,55442,0,0,66,66,0,1,0,1,0
54620,80,5302,80,14855,1611,13244,26,77,14,12
49692,53,30173,53,212,110,102,2,30,1,1
55581,53,26872,53,167,86,81,2,30,1,1
54197,443,1352,443,499,425,74,4,0,3,1
6881,21162,0,0,146,146,0,1,0,1,0
65511,53,46791,53,214,102,112,2,30,1,1
46492,443,13641,443,11163,3642,7521,25,30,14,11
53910,443,14287,443,499,425,74,4,0,3,1
51575,9694,0,0,62,62,0,1,0,1,0
59001,445,0,0,70,70,0,1,0,1,0
64609,53,19942,53,168,86,82,2,30,1,1
17027,1,0,0,62,62,0,1,0,1,0
49117,443,48924,443,9551,2173,7378,33,27,17,16
63972,53,28656,53,325,94,231,2,30,1,1
63950,53,19633,53,200,102,98,2,30,1,1
37736,443,59185,443,16925,11562,5363,36,363,19,17
55744,80,6834,80,5146,3694,1452,20,249,10,10
65493,443,24258,443,7975,423,7552,15,120,6,9
50566,443,28525,443,7367,1149,6218,18,27,9,9
57448,53,10658,53,177,94,83,2,29,1,1
30188,14038,49780,14038,502,150,352,2,1200,1,1
58564,50432,0,0,66,66,0,1,0,1,0
43584,24748,0,0,156,156,0,1,0,1,0
13441,57470,0,0,62,62,0,1,0,1,0
42128,54532,0,0,60,60,0,1,0,1,0
57568,53,57568,53,235,98,137,2,30,1,1
51183,56205,0,0,62,62,0,1,0,1,0
64228,53,55912,53,266,110,156,2,30,1,1
43394,53,50886,53,168,78,90,2,31,1,1
53911,445,0,0,70,70,0,1,0,1,0
45269,50584,0,0,62,62,0,1,0,1,0
30960,45682,63379,45682,330,330,0,6,3609,6,0
60387,80,36861,80,214,140,74,4,15,3,1
1930,80,62505,80,214,140,74,4,15,3,1
48817,13259,48817,13259,460,150,310,2,1200,1,1
64994,53,18089,53,216,102,114,2,30,1,1
60165,445,0,0,70,70,0,1,0,1,0
2697,28189,0,0,60,60,0,1,0,1,0
50873,443,21465,443,6889,1381,5508,19,129,9,10
49716,443,56032,443,4653,785,3868,14,52,6,8
52161,19897,63116,19897,70,70,0,2,8,2,0
63991,80,39490,80,314,192,122,6,15,4,2
56678,53,49059,53,240,110,130,2,30,1,1
51903,35904,6046,35904,70,70,0,2,8,2,0
53465,57470,0,0,62,62,0,1,0,1,0
57019,53,50222,53,193,102,91,2,30,1,1
65176,53,60246,53,299,103,196,4,53,2,2
26330,26348,0,0,62,62,0,1,0,1,0
55607,17820,29778,17820,504,318,186,8,16,5,3
55877,53546,37144,53546,481,150,331,2,1200,1,1
53122,443,60812,443,12409,2224,10185,36,26,19,17
49918,80,19931,80,751,455,296,8,125,5,3
26332,57470,0,0,62,62,0,1,0,1,0
37965,15357,58016,15357,481,150,331,2,1200,1,1
60602,15503,0,0,66,66,0,1,0,1,0
60885,443,21890,443,3855,2679,1176,28,45,15,13
53447,22114,0,0,146,146,0,1,0,1,0
56258,53,50751,53,772,103,669,2,30,1,1
60980,443,25213,443,134,60,74,3,6,2,1
55684,53,46714,53,214,110,104,2,30,1,1
49891,445,0,0,66,66,0,1,0,1,0
64618,445,0,0,66,66,0,1,0,1,0
49837,53,44716,53,734,86,648,2,30,1,1
50601,443,53899,443,5035,3194,1841,23,72,12,11
49651,445,0,0,70,70,0,1,0,1,0
53258,53,63456,53,277,78,199,2,30,1,1
1972,57470,0,0,78,78,0,1,0,1,0
37581,53,0,0,86,86,0,1,30,1,0
50584,6889,32589,6889,311,311,0,3,1200,3,0
65251,53,19717,53,819,102,717,2,30,1,1
38469,80,38469,80,555104,4582,550522,446,20,60,386
35269,61903,0,0,145,145,0,1,0,1,0
51617,21247,0,0,66,66,0,1,0,1,0
55103,445,0,0,70,70,0,1,0,1,0
62392,445,0,0,70,70,0,1,0,1,0
55008,21247,0,0,66,66,0,1,0,1,0
53353,26467,0,0,62,62,0,1,0,1,0
55435,443,60769,443,684908,25994,658914,762,141,263,499
27442,44847,0,0,62,62,0,1,0,1,0
56049,445,0,0,66,66,0,1,0,1,0
52537,445,0,0,66,66,0,1,0,1,0
64929,53,59059,53,168,86,82,2,30,1,1
49272,53,48276,53,168,86,82,2,33,1,1
58993,443,55872,443,416,210,206,7,26,4,3
56415,53,18388,53,179,94,85,2,29,1,1
64326,53,28923,53,192,98,94,2,31,1,1
57400,443,4312,443,10169,1957,8212,26,136,11,15
52059,47363,55015,47363,70,70,0,1,5,1,0
57022,443,20898,443,4228,1470,2758,19,131,9,10
64997,53,32660,53,771,102,669,2,29,1,1
55179,443,6638,443,5839,1984,3855,19,18,11,8
51130,80,19465,80,366,240,126,7,21,5,2
51931,443,20564,443,2328,1677,651,17,23,9,8
57504,44847,0,0,66,66,0,1,0,1,0
64673,6881,0,0,66,66,0,1,0,1,0
50240,53,16161,53,733,93,640,2,30,1,1
56298,445,0,0,70,70,0,1,0,1,0
53864,53,19118,53,168,78,90,2,30,1,1
60116,443,14734,443,9454,2307,7147,40,19,17,23
55727,43736,19578,43736,70,70,0,1,5,1,0
58976,43890,0,0,66,66,0,1,0,1,0
65176,53,2902,53,186,95,91,2,30,1,1
34176,51505,0,0,62,62,0,1,0,1,0
57439,443,32851,443,5502,1543,3959,17,20,9,8
56031,53,4995,53,177,94,83,2,29,1,1
49229,53,47924,53,183,94,89,2,30,1,1
50373,443,34130,443,5422,707,4715,16,25,8,8
63221,53436,0,0,62,62,0,1,0,1,0
56775,53,1038,53,733,85,648,2,30,1,1
2182,53,2182,53,643,88,555,2,30,1,1
55467,445,0,0,70,70,0,1,0,1,0
64724,53,45753,53,336,110,226,2,30,1,1
58649,443,35795,443,7701,2215,5486,28,373,14,14
60646,11392,0,0,66,66,0,1,0,1,0
52450,445,0,0,70,70,0,1,0,1,0
55600,22,0,0,60,60,0,1,0,1,0
64959,53,63198,53,245,102,143,2,31,1,1
51913,52188,58050,52188,66,66,0,1,5,1,0
18116,37807,0,0,66,66,0,1,0,1,0
56205,53,15763,53,240,110,130,2,30,1,1
52303,445,0,0,66,66,0,1,0,1,0
58173,993,62958,993,430,60,370,7,24,2,5
57427,53,45535,53,363,94,269,2,30,1,1
51999,445,0,0,70,70,0,1,0,1,0
56927,53,35589,53,183,94,89,2,30,1,1
13375,53,13375,53,213,82,131,2,30,1,1
56387,25174,0,0,62,62,0,1,0,1,0
54991,36829,0,0,66,66,0,1,0,1,0
61363,445,0,0,70,70,0,1,0,1,0
38714,443,54689,443,90043,3609,86434,97,15,33,64
58902,445,0,0,70,70,0,1,0,1,0
41885,25174,0,0,66,66,0,1,0,1,0
26867,443,1450,443,11115,3034,8081,35,19,18,17
50156,443,23478,443,6666,1682,4984,28,1157,15,13
63756,445,0,0,66,66,0,1,0,1,0
51880,443,34522,443,4358,1056,3302,16,30,9,7
49716,445,0,0,66,66,0,1,0,1,0
62230,443,57839,443,3709,1176,2533,14,135,7,7
50556,445,0,0,70,70,0,1,0,1,0
39343,443,19498,443,8562,1634,6928,27,26,13,14
64684,445,0,0,70,70,0,1,0,1,0
43747,22114,0,0,62,62,0,1,0,1,0
56236,443,26673,443,9597,2488,7109,32,287,16,16
55216,53,32573,53,179,94,85,2,30,1,1
65448,53,13119,53,209,110,99,2,30,1,1
55497,445,0,0,66,66,0,1,0,1,0
51983,443,27301,443,23955,4211,19744,42,46,21,21
52976,31573,0,0,66,66,0,1,0,1,0
57098,80,38453,80,819,530,289,8,40,5,3
59443,445,0,0,70,70,0,1,0,1,0
49874,443,3516,443,6058,1037,5021,20,54,11,9
59301,445,0,0,66,66,0,1,0,1,0
56357,53,8894,53,168,86,82,2,30,1,1
49551,445,0,0,70,70,0,1,0,1,0
62009,443,59530,443,5017,1969,3048,14,136,7,7
61697,443,10867,443,9963,2631,7332,37,48,20,17
60964,443,25466,443,2080,1376,704,17,30,9,8
58825,443,1318,443,6357,4318,2039,22,16,11,11
56102,445,0,0,66,66,0,1,0,1,0
53301,11000,8510,11000,1642,822,820,5,30,1,4
49393,30188,0,0,66,66,0,1,0,1,0
55251,445,0,0,70,70,0,1,0,1,0
55262,53,22053,53,193,102,91,2,30,1,1
53859,443,52772,443,499,425,74,4,1,3,1
49700,53,14464,53,165,78,87,2,30,1,1
58638,5900,0,0,62,62,0,1,0,1,0
65123,53,3182,53,193,102,91,2,29,1,1
57107,64147,0,0,62,62,0,1,0,1,0
55058,53,41146,53,216,110,106,2,31,1,1
11295,40002,5818,40002,356,170,186,6,53,3,3
57367,53,62826,53,170,87,83,2,30,1,1
53674,31724,6450,31724,70,70,0,1,4,1,0
49747,53,62194,53,355,102,253,2,30,1,1
65107,53,32581,53,266,110,156,2,30,1,1
54210,36237,0,0,62,62,0,1,0,1,0
56686,445,0,0,70,70,0,1,0,1,0
64305,445,0,0,70,70,0,1,0,1,0
18652,64147,0,0,62,62,0,1,0,1,0
65530,53,20918,53,167,86,81,2,29,1,1
41207,5900,0,0,60,60,0,1,0,1,0
23277,53733,0,0,62,62,0,1,0,1,0
62737,64147,0,0,66,66,0,1,0,1,0
52632,443,1395,443,4399,1857,2542,28,136,14,14
35400,443,23133,443,11083,4080,7003,38,40,14,24
51609,443,37311,443,4598,2312,2286,17,34,9,8
43817,443,47281,443,5911,1666,4245,27,18,15,12
7810,25174,0,0,62,62,0,1,0,1,0
54633,445,0,0,70,70,0,1,0,1,0
53897,445,0,0,66,66,0,1,0,1,0
49393,30188,0,0,66,66,0,1,0,1,0
53174,41442,6472,41442,70,70,0,2,8,2,0
54956,53,14576,53,194,102,92,2,31,1,1
65377,53,55727,53,207,86,121,2,30,1,1
49259,445,0,0,70,70,0,1,0,1,0
57323,53,27696,53,194,102,92,2,30,1,1
61373,445,0,0,66,66,0,1,0,1,0
36993,443,63240,443,7768,3071,4697,23,17,12,11
60085,445,0,0,70,70,0,1,0,1,0
50319,445,0,0,70,70,0,1,0,1,0
55019,445,0,0,70,70,0,1,0,1,0
54365,443,56544,443,3970,1726,2244,13,134,6,7
17315,11392,0,0,62,62,0,1,0,1,0
65487,445,0,0,70,70,0,1,0,1,0
60149,445,0,0,66,66,0,1,0,1,0
64937,53,42639,53,204,104,100,2,31,1,1
64765,53,34365,53,195,94,101,2,30,1,1
56563,53,53188,53,292,126,166,2,30,1,1
64994,443,32046,443,3547,1351,2196,17,135,8,9
58849,64147,0,0,66,66,0,1,0,1,0
53791,16881,2744,16881,70,70,0,1,5,1,0
52039,80,22816,80,4185,3462,723,14,15,7,7
51944,12470,26336,12470,316,136,180,6,6,3,3
55919,53,57611,53,754,94,660,2,31,1,1
51485,445,0,0,70,70,0,1,0,1,0
16134,45680,0,0,148,148,0,1,0,1,0
26900,27017,33518,27017,422,164,258,6,30,3,3
56803,53,10846,53,195,102,93,2,30,1,1
53536,443,47086,443,7901,3483,4418,24,30,13,11
49160,33586,34033,33586,1377,300,1077,6,1200,3,3
54343,445,0,0,70,70,0,1,0,1,0
52158,443,56576,443,2149,1549,600,14,45,8,6
51797,30712,27964,30712,70,70,0,1,5,1,0
47876,443,34439,443,996037,37114,958923,1187,271,459,728
49383,445,0,0,66,66,0,1,0,1,0
49418,27054,42342,27054,272,78,194,2,30,1,1
58638,5900,0,0,62,62,0,1,0,1,0
16387,35244,0,0,60,60,0,1,0,1,0
53213,443,51742,443,8451,2320,6131,25,104,13,12
54430,445,0,0,70,70,0,1,0,1,0
32843,443,63526,443,6444,2640,3804,18,122,9,9
58638,5900,0,0,62,62,0,1,0,1,0
49952,53,50731,53,190,97,93,2,30,1,1
58185,445,0,0,70,70,0,1,0,1,0
51100,80,29611,80,12300,4454,7846,26,30,13,13
55488,57470,0,0,145,145,0,1,0,1,0
44984,80,44984,80,7061,2943,4118,16,23,9,7
55021,53,4080,53,174,89,85,2,31,1,1
57450,445,0,0,70,70,0,1,0,1,0
60501,40829,17093,40829,70,70,0,1,5,1,0
50052,65008,0,0,60,60,0,1,0,1,0
60896,445,0,0,66,66,0,1,0,1,0
59037,51505,0,0,66,66,0,1,0,1,0
52054,50513,38403,50513,70,70,0,2,9,2,0
55765,443,54125,443,4660,1915,2745,23,120,12,11
55146,53,34694,53,181,94,87,2,30,1,1
55129,53,28774,53,754,94,660,2,31,1,1
53785,33324,8660,33324,70,70,0,1,4,1,0
58806,443,62353,443,10442,6793,3649,30,17,16,14
49001,40108,0,0,161,161,0,1,0,1,0
55842,443,52718,443,8661,2036,6625,40,256,19,21
23807,44847,0,0,66,66,0,1,0,1,0
58638,5900,0,0,62,62,0,1,0,1,0
58725,7302,0,0,66,66,0,1,0,1,0
65291,53,62097,53,247,118,129,2,30,1,1
64295,26467,0,0,62,62,0,1,0,1,0
6843,42873,0,0,62,62,0,1,0,1,0
63607,53,63607,53,643,88,555,2,30,1,1
52865,443,62658,443,120290,2988,117302,123,132,32,91
50572,445,0,0,70,70,0,1,0,1,0
1024,64147,0,0,62,62,0,1,0,1,0
56000,53,49191,53,177,94,83,2,30,1,1
19361,23117,0,0,66,66,0,1,0,1,0
55519,445,0,0,70,70,0,1,0,1,0
55917,53,22277,53,177,94,83,2,30,1,1
30270,37965,0,0,66,66,0,1,0,1,0
55205,53,56363,53,167,86,81,2,30,1,1
53828,51354,7216,51354,70,70,0,2,8,2,0
42598,443,46015,443,3134,1983,1151,15,15,8,7
54746,445,0,0,70,70,0,1,0,1,0
61719,80,27024,80,32457,1499,30958,42,50,16,26
49472,80,16724,80,318,192,126,6,28,4,2
56192,445,0,0,66,66,0,1,0,1,0
52040,2524,48292,2524,70,70,0,1,5,1,0
64709,53,11434,53,821,102,719,2,30,1,1
54658,445,0,0,70,70,0,1,0,1,0
39814,443,9384,443,5761,3561,2200,45,51,23,22
57386,53,9687,53,186,95,91,2,31,1,1
59792,80,7891,80,1453540,37280,1416260,1552,96,507,1045
58805,443,39224,443,9030,2311,6719,24,362,13,11
56469,445,0,0,70,70,0,1,0,1,0
58933,443,10888,443,5167,700,4467,16,15,7,9
49489,443,58403,443,3170,977,2193,13,135,6,7
21424,53,21424,53,225,90,135,2,29,1,1
63034,443,35751,443,304,86,218,2,30,1,1
62683,445,0,0,66,66,0,1,0,1,0
56285,445,0,0,70,70,0,1,0,1,0
23658,18375,0,0,62,62,0,1,0,1,0
57700,53,7203,53,308,118,190,2,29,1,1
52644,6881,4484,6881,719,413,306,10,14,5,5
51207,445,0,0,70,70,0,1,0,1,0
38406,443,5076,443,564,292,272,9,26,5,4
51807,10920,61477,10920,70,70,0,1,5,1,0
21674,28189,0,0,60,60,0,1,0,1,0
49434,53,30404,53,326,134,192,2,30,1,1
55771,53,45760,53,283,98,185,4,51,2,2
46949,53,11241,53,168,78,90,2,29,1,1
46557,57866,0,0,66,66,0,1,0,1,0
51945,1587,2517,1587,66,66,0,1,5,1,0
21892,15503,0,0,62,62,0,1,0,1,0
56242,445,0,0,70,70,0,1,0,1,0
22541,64147,0,0,66,66,0,1,0,1,0
49629,443,16590,443,5600,1187,4413,24,80,13,11
38113,443,46610,443,2849678,105912,2743766,3255,124,1284,1971
50917,445,0,0,66,66,0,1,0,1,0
22409,55442,0,0,74,74,0,1,0,1,0
53902,55298,4313,55298,70,70,0,2,8,2,0
55393,44512,0,0,66,66,0,1,0,1,0
38295,443,36563,443,5247,3662,1585,21,310,11,10
53166,80,34843,80,1487,838,649,10,323,6,4
56521,32480,0,0,62,62,0,1,0,1,0
50017,445,0,0,70,70,0,1,0,1,0
10243,36237,0,0,62,62,0,1,0,1,0
58052,80,61267,80,1550,853,697,9,15,5,4
52432,445,0,0,70,70,0,1,0,1,0
65144,53,10538,53,210,110,100,2,30,1,1
2543,25174,0,0,66,66,0,1,0,1,0
56441,80,25376,80,130,70,60,2,15,1,1
50970,80,61956,80,11340,3061,8279,31,115,12,19
48817,51414,48817,51414,150,150,0,1,1200,1,0
60880,443,53335,443,12278,1931,10347,32,56,18,14
56612,443,41735,443,8033,2013,6020,20,15,11,9
56131,445,0,0,70,70,0,1,0,1,0
52629,445,0,0,70,70,0,1,0,1,0
51139,80,1947,80,124,64,60,2,15,1,1
61436,443,20457,443,1401,940,461,11,29,7,4
55146,1433,0,0,60,60,0,1,0,1,0
56391,53,63935,53,758,93,665,2,31,1,1
54168,80,20934,80,1582,1003,579,12,360,6,6
55524,53,55524,53,197,90,107,2,29,1,1
54977,445,0,0,70,70,0,1,0,1,0
53063,80,2438,80,2725,1228,1497,24,90,13,11
19473,44929,9531,44929,481,150,331,2,1200,1,1
64639,53,49663,53,199,102,97,2,31,1,1
64820,53,13245,53,190,97,93,2,31,1,1
49940,443,15585,443,4363,1298,3065,17,127,8,9
50589,445,0,0,70,70,0,1,0,1,0
53568,445,0,0,66,66,0,1,0,1,0
1027,57866,0,0,62,62,0,1,0,1,0
26900,27017,40342,27017,422,164,258,6,30,3,3
50201,445,0,0,70,70,0,1,0,1,0
49742,53,64012,53,731,91,640,2,30,1,1
64878,26467,0,0,62,62,0,1,0,1,0
56586,53,7181,53,177,94,83,2,30,1,1
28624,23,0,0,60,60,0,1,0,1,0
54531,445,0,0,70,70,0,1,0,1,0
63888,6881,45286,6881,70,70,0,1,5,1,0
50734,37965,0,0,62,62,0,1,0,1,0
51553,443,28429,443,6662,522,6140,15,16,5,10
57591,53,13897,53,165,78,87,2,31,1,1
44919,26467,0,0,62,62,0,1,0,1,0
58888,443,13119,443,274616,12640,261976,352,28,167,185
50047,80,4097,80,1455,349,1106,10,15,5,5
56431,53,59476,53,177,94,83,2,30,1,1
65325,445,0,0,70,70,0,1,0,1,0
49418,27015,56301,27015,258,71,187,2,30,1,1
19204,57866,0,0,66,66,0,1,0,1,0
56723,53,2628,53,733,85,648,2,31,1,1
64706,53,11232,53,179,94,85,2,29,1,1
49985,443,2510,443,10737,3664,7073,20,137,10,10
60438,445,0,0,66,66,0,1,0,1,0
64748,53,7421,53,152,78,74,2,30,1,1
53904,443,54254,443,495,421,74,4,0,3,1
49418,27016,33402,27016,259,78,181,2,29,1,1
49742,443,32248,443,4490,750,3740,16,128,8,8
55184,53,64437,53,182,93,89,2,31,1,1
53765,443,24226,443,16482,9312,7170,39,141,19,20
65273,445,0,0,70,70,0,1,0,1,0
62637,42873,0,0,66,66,0,1,0,1,0
51742,30317,0,0,66,66,0,1,0,1,0
61054,53,61054,53,237,91,146,2,33,1,1
55463,53,33769,53,216,110,106,2,29,1,1
49343,445,0,0,66,66,0,1,0,1,0
59775,443,26264,443,5024,2538,2486,23,15,13,10
39714,443,60107,443,922046,41258,880788,1106,218,498,608
58064,445,0,0,70,70,0,1,0,1,0
61552,443,61552,443,38146,3555,34591,57,16,28,29
36946,123,44700,123,184,94,90,2,30,1,1
51813,63933,50803,63933,70,70,0,2,8,2,0
57354,53,26026,53,177,94,83,2,29,1,1
49995,445,0,0,70,70,0,1,0,1,0
2402,7000,2402,7000,1236,676,560,13,22,7,6
52727,445,0,0,66,66,0,1,0,1,0
51198,443,22207,443,8075,2723,5352,42,117,24,18
57323,53,18058,53,188,96,92,2,31,1,1
443,29326,0,0,82,82,0,1,0,1,0
45428,80,14591,80,350,210,140,6,28,4,2
58638,5900,0,0,62,62,0,1,0,1,0
47483,53,19312,53,164,78,86,2,30,1,1
34429,443,39079,443,1701,1048,653,15,38,8,7
38633,51221,0,0,66,66,0,1,0,1,0
63771,445,0,0,70,70,0,1,0,1,0
60617,64147,0,0,62,62,0,1,0,1,0
56416,53,30154,53,816,102,714,2,30,1,1
20057,44847,0,0,62,62,0,1,0,1,0
64276,445,0,0,66,66,0,1,0,1,0
11295,40032,25935,40032,148,86,62,2,30,1,1
53681,31466,20007,31466,70,70,0,1,5,1,0
25010,30188,0,0,62,62,0,1,0,1,0
62184,445,0,0,70,70,0,1,0,1,0
59114,445,0,0,70,70,0,1,0,1,0
64657,53,3237,53,193,102,91,2,30,1,1
64166,35440,0,0,66,66,0,1,0,1,0
45218,25174,0,0,62,62,0,1,0,1,0
57470,867,17411,867,330,330,0,6,1200,6,0
49455,445,0,0,66,66,0,1,0,1,0
49542,443,62121,443,40423,35897,4526,52,16,33,19
52039,38541,31838,38541,70,70,0,2,7,2,0
54858,51505,0,0,62,62,0,1,0,1,0
49527,53,30173,53,165,86,79,2,30,1,1
56510,443,37047,443,8742,2483,6259,41,114,22,19
36541,443,3197,443,4322,797,3525,14,64,8,6
49691,53,43996,53,378,127,251,2,30,1,1
51235,445,0,0,70,70,0,1,0,1,0
55869,53,64090,53,196,102,94,2,30,1,1
58273,53,40385,53,202,86,116,2,30,1,1
58003,1433,0,0,60,60,0,1,0,1,0
54891,445,0,0,70,70,0,1,0,1,0
64586,53,9543,53,183,94,89,2,30,1,1
44034,80,44034,80,18510,706,17804,22,16,6,16
63196,445,0,0,70,70,0,1,0,1,0
40797,25174,0,0,62,62,0,1,0,1,0
54953,53,51225,53,289,134,155,2,30,1,1
57444,53,13400,53,198,94,104,2,29,1,1
5227,50584,0,0,146,146,0,1,0,1,0
60088,443,5059,443,1000,557,443,11,141,6,5
49615,53,30558,53,413,170,243,6,31,3,3
63080,443,52084,443,304,86,218,2,30,1,1
39941,2767,0,0,62,62,0,1,0,1,0
23843,26467,0,0,62,62,0,1,0,1,0
56416,53,40943,53,969,86,883,2,29,1,1
49381,53,64109,53,230,102,128,2,29,1,1
62413,445,0,0,66,66,0,1,0,1,0
39287,57470,0,0,62,62,0,1,0,1,0
50637,44847,0,0,62,62,0,1,0,1,0
7749,36237,0,0,66,66,0,1,0,1,0
50661,445,0,0,70,70,0,1,0,1,0
33931,50584,0,0,62,62,0,1,0,1,0
50513,443,44199,443,9766,1810,7956,30,86,16,14
64023,53,59287,53,174,89,85,2,30,1,1
52327,53,21249,53,224,94,130,2,29,1,1
55008,445,0,0,70,70,0,1,0,1,0
36435,443,62505,443,7046,3518,3528,66,612,35,31
52179,443,33825,443,7439,1156,6283,19,75,11,8
993,49276,0,0,129,129,0,1,0,1,0
51982,56306,48759,56306,70,70,0,2,8,2,0
37805,443,7210,443,9481,3482,5999,58,16,29,29
59784,42246,0,0,62,62,0,1,0,1,0
46009,53,4263,53,199,94,105,2,30,1,1
40926,53,16373,53,168,78,90,2,30,1,1
53536,34200,55165,34200,70,70,0,1,4,1,0
55430,445,0,0,70,70,0,1,0,1,0
51158,445,0,0,70,70,0,1,0,1,0
53073,32468,0,0,66,66,0,1,0,1,0
52714,64147,0,0,66,66,0,1,0,1,0
53908,443,36300,443,499,425,74,4,0,3,1
28378,56205,0,0,62,62,0,1,0,1,0
64823,53,30935,53,508,102,406,2,30,1,1
64145,53,5953,53,504,105,399,4,35,2,2
49609,53,20657,53,177,94,83,2,29,1,1
58513,445,0,0,70,70,0,1,0,1,0
7539,53,7539,53,194,87,107,2,30,1,1
55740,8060,29494,8060,70,70,0,2,7,2,0
31609,25174,0,0,62,62,0,1,0,1,0
60514,39004,0,0,62,62,0,1,0,1,0
55276,53,25720,53,177,94,83,2,29,1,1
52127,445,0,0,66,66,0,1,0,1,0
6666,2222,0,0,60,60,0,1,0,1,0
49862,53,40662,53,180,94,86,2,30,1,1
55464,22114,0,0,62,62,0,1,0,1,0
50242,80,35975,80,2793,1071,1722,14,105,7,7
54559,445,0,0,70,70,0,1,0,1,0
56595,80,43530,80,234,234,0,4,12,4,0
25209,53,25209,53,240,98,142,2,30,1,1
51328,30228,0,0,109,109,0,1,0,1,0
54403,445,0,0,70,70,0,1,0,1,0
28121,443,57798,443,9075,2662,6413,34,462,16,18
49585,53,39603,53,732,86,646,2,30,1,1
55563,53,39714,53,194,102,92,2,30,1,1
49516,53,31257,53,183,94,89,2,29,1,1
45007,22114,0,0,146,146,0,1,0,1,0
63904,18268,47003,18268,66,66,0,2,7,2,0
50174,445,0,0,70,70,0,1,0,1,0
59980,443,52666,443,345468,18536,326932,432,22,200,232
54239,443,8377,443,499,425,74,4,0,3,1
59413,51505,0,0,62,62,0,1,0,1,0
54734,445,0,0,70,70,0,1,0,1,0
48163,53,27599,53,199,94,105,2,30,1,1
64013,57470,0,0,74,74,0,1,0,1,0
55835,62413,0,0,62,62,0,1,0,1,0
58638,5900,0,0,62,62,0,1,0,1,0
52907,80,17763,80,1659,653,1006,10,16,6,4
41801,53,41801,53,213,87,126,2,30,1,1
64996,27034,9075,27034,1761,924,837,6,30,3,3
48163,443,22836,443,20124,12085,8039,54,385,29,25
60205,53,4372,53,491,115,376,2,31,1,1
62171,445,0,0,66,66,0,1,0,1,0
43350,58414,0,0,66,66,0,1,0,1,0
58638,5900,0,0,62,62,0,1,0,1,0
49872,53,36268,53,331,126,205,2,30,1,1
65020,53,48553,53,184,94,90,2,30,1,1
58638,5900,58638,5900,130,66,64,2,4,1,1
64396,53,16886,53,231,102,129,2,30,1,1
38664,37965,0,0,62,62,0,1,0,1,0
42298,40007,25770,40007,206,84,122,4,29,2,2
14165,51050,0,0,146,146,0,1,0,1,0
51923,443,5090,443,8964,6357,2607,44,163,23,21
60049,25174,0,0,66,66,0,1,0,1,0
64657,53,12172,53,312,94,218,2,30,1,1
54519,443,53980,443,8413,2503,5910,23,16,13,10
64155,53,47794,53,182,93,89,2,31,1,1
54754,50432,0,0,66,66,0,1,0,1,0
60763,40010,33856,40010,316,136,180,6,6,3,3
57671,445,0,0,70,70,0,1,0,1,0
51461,445,0,0,66,66,0,1,0,1,0
50116,22,50116,22,60,60,0,1,5,1,0
60852,445,0,0,70,70,0,1,0,1,0
55605,53,6586,53,195,102,93,2,30,1,1
64474,445,0,0,66,66,0,1,0,1,0
50116,22,50116,22,66,66,0,1,5,1,0
58395,53,61283,53,307,86,221,2,30,1,1
63873,445,0,0,66,66,0,1,0,1,0
49533,445,0,0,70,70,0,1,0,1,0
64572,37965,0,0,66,66,0,1,0,1,0
61642,445,0,0,66,66,0,1,0,1,0
51161,445,0,0,70,70,0,1,0,1,0
58895,445,0,0,66,66,0,1,0,1,0
57013,445,0,0,70,70,0,1,0,1,0
1025,35447,0,0,62,62,0,1,0,1,0
48337,443,44874,443,227876,8050,219826,236,36,83,153
51999,37965,0,0,62,62,0,1,0,1,0
18423,51505,0,0,62,62,0,1,0,1,0
63384,445,0,0,66,66,0,1,0,1,0
59997,443,42772,443,1571,660,911,13,18,7,6
55054,445,0,0,66,66,0,1,0,1,0
65316,445,0,0,70,70,0,1,0,1,0
52562,445,0,0,70,70,0,1,0,1,0
59222,445,0,0,66,66,0,1,0,1,0
53118,445,0,0,70,70,0,1,0,1,0
27651,53,46551,53,225,78,147,2,30,1,1
33595,23,0,0,60,60,0,1,0,1,0
57883,443,47068,443,1786,1147,639,17,177,10,7
57673,445,0,0,66,66,0,1,0,1,0
56940,80,57845,80,606,70,536,10,278,2,8
56860,49991,37577,49991,70,70,0,2,8,2,0
49332,443,62500,443,27727,1971,25756,51,80,21,30
50506,10214,0,0,66,66,0,1,0,1,0
10480,26467,0,0,62,62,0,1,0,1,0
61411,80,31645,80,145440,11034,134406,292,158,135,157
52930,445,0,0,70,70,0,1,0,1,0
50204,80,48586,80,1221,781,440,11,14,6,5
33041,443,60563,443,12375,6777,5598,28,49,13,15
52092,443,50536,443,4642,3496,1146,18,16,10,8
26301,22114,0,0,62,62,0,1,0,1,0
52094,55986,52536,55986,70,70,0,2,8,2,0
5588,5588,0,0,3354,1792,1562,46,195,23,23
50949,445,0,0,70,70,0,1,0,1,0
56173,445,0,0,70,70,0,1,0,1,0
50349,443,62395,443,1385,868,517,12,30,6,6
55184,53,63377,53,183,94,89,2,30,1,1
56837,53,17666,53,190,97,93,2,31,1,1
43841,443,59699,443,6516,3085,3431,33,80,17,16
60358,443,56425,443,17547,2695,14852,30,76,14,16
44414,23718,0,0,66,66,0,1,0,1,0
49206,53,3418,53,448,184,264,6,30,3,3
54491,445,0,0,70,70,0,1,0,1,0
55587,43890,0,0,66,66,0,1,0,1,0
65074,443,20920,443,7584,7094,490,14,124,7,7
54572,445,0,0,70,70,0,1,0,1,0
56760,48386,9485,48386,268,70,198,4,19,1,3
61831,443,61831,443,530764,27638,503126,528,175,179,349
57275,53,32208,53,177,94,83,2,31,1,1
55979,53,60691,53,193,102,91,2,30,1,1
50917,80,57551,80,11626518,135099,11491419,9627,134,1907,7720
65456,53,31398,53,364,102,262,2,29,1,1
56690,445,0,0,66,66,0,1,0,1,0
56100,53,9631,53,177,94,83,2,30,1,1
53141,8595,63363,8595,70,70,0,2,8,2,0
65231,53,56850,53,200,102,98,2,30,1,1
50265,25490,26928,25490,1766,1332,434,22,1200,15,7
49584,445,0,0,70,70,0,1,0,1,0
50316,37965,0,0,66,66,0,1,0,1,0
63670,64097,0,0,66,66,0,1,0,1,0
48301,25174,0,0,66,66,0,1,0,1,0
59477,36829,0,0,62,62,0,1,0,1,0
56186,57470,0,0,62,62,0,1,0,1,0
64578,53,11531,53,193,102,91,2,30,1,1
58677,445,0,0,70,70,0,1,0,1,0
59977,445,0,0,70,70,0,1,0,1,0
52186,445,0,0,70,70,0,1,0,1,0
55032,443,19722,443,8965,3021,5944,39,360,22,17
63586,46824,0,0,62,62,0,1,0,1,0
33292,50584,0,0,66,66,0,1,0,1,0
49761,80,49761,80,2937,703,2234,13,142,6,7
53710,443,55386,443,499,425,74,4,0,3,1
60812,443,60812,443,2871,1671,1200,17,179,9,8
61080,445,0,0,66,66,0,1,0,1,0
17735,53,27345,53,223,86,137,2,29,1,1
13188,35440,0,0,66,66,0,1,0,1,0
55955,53,56880,53,184,94,90,2,30,1,1
50343,80,37536,80,1192,658,534,11,41,6,5
48188,443,44045,443,1263,536,727,13,82,6,7
49353,53,9997,53,237,94,143,2,30,1,1
33733,443,7805,443,6998,2361,4637,20,17,10,10
55199,53,62103,53,196,94,102,2,30,1,1
52741,443,63085,443,85011,4398,80613,113,26,52,61
56849,443,44408,443,7374,2085,5289,33,270,18,15
47264,80,26226,80,1737,796,941,12,16,7,5
64085,443,64085,443,140818,8751,132067,156,168,57,99
34165,443,5648,443,8208,2080,6128,24,81,14,10
56953,80,31471,80,37311,3340,33971,52,65,26,26
48444,53,53992,53,164,78,86,2,30,1,1
57340,53,29949,53,216,110,106,2,30,1,1
17640,55442,0,0,62,62,0,1,0,1,0
49896,443,39739,443,151170,17408,133762,256,130,118,138
61589,443,61589,443,4672,1765,2907,19,28,11,8
53676,35974,0,0,60,60,0,1,0,1,0
61788,445,0,0,70,70,0,1,0,1,0
49460,445,0,0,66,66,0,1,0,1,0
50584,1283,8544,1283,1617,161,1456,4,1199,2,2
48303,53,44805,53,198,93,105,2,31,1,1
12232,41864,0,0,139,139,0,1,0,1,0
2717,31573,0,0,66,66,0,1,0,1,0
54449,443,54449,443,7974,2926,5048,25,17,15,10
58638,5900,0,0,62,62,0,1,0,1,0
56800,1,46367,1,70,70,0,1,5,1,0
49479,7000,49479,7000,5200,3745,1455,18,15,10,8
9230,443,20303,443,6020,792,5228,18,25,9,9
37732,5007,0,0,60,60,0,1,0,1,0
51829,36134,0,0,66,66,0,1,0,1,0
64818,53,61380,53,260,102,158,2,30,1,1
63125,445,0,0,66,66,0,1,0,1,0
46767,443,3623,443,8376,2231,6145,25,330,12,13
49478,80,36631,80,28629,4862,23767,33,39,13,20
59021,443,44226,443,4596,1442,3154,24,154,11,13
64091,53,52948,53,172,88,84,2,30,1,1
51521,443,51521,443,138679,4142,134537,141,173,33,108
60804,445,0,0,70,70,0,1,0,1,0
56526,443,53927,443,1560,988,572,13,25,7,6
24560,25174,0,0,62,62,0,1,0,1,0
61185,54532,0,0,62,62,0,1,0,1,0
49436,53,51466,53,765,102,663,2,30,1,1
16620,25174,0,0,62,62,0,1,0,1,0
59626,22114,0,0,66,66,0,1,0,1,0
64615,53,56632,53,395,89,306,4,32,2,2
50228,445,0,0,66,66,0,1,0,1,0
58602,445,0,0,70,70,0,1,0,1,0
60929,28678,34471,28678,1806,1806,0,22,224,22,0
51433,443,11382,443,194,70,124,3,11,1,2
58638,5900,0,0,62,62,0,1,0,1,0
56355,443,33571,443,3734,1750,1984,24,203,12,12
51704,443,61850,443,7117,619,6498,19,34,6,13
64279,53,29219,53,177,94,83,2,29,1,1
51508,4545,51508,4545,156,156,0,3,8,3,0
29805,53,29805,53,226,89,137,2,30,1,1
64001,53,5288,53,182,93,89,2,30,1,1
60374,80,60374,80,118413,7486,110927,151,33,70,81
49889,53,48150,53,197,102,95,2,31,1,1
50413,445,0,0,70,70,0,1,0,1,0
37555,16384,64075,16384,432,192,240,8,30,4,4
15629,53,15629,53,209,77,132,2,32,1,1
53999,445,0,0,70,70,0,1,0,1,0
56783,53,3501,53,186,95,91,2,30,1,1
4760,44847,0,0,62,62,0,1,0,1,0
60827,53,38613,53,224,86,138,2,29,1,1
50938,445,0,0,66,66,0,1,0,1,0
27005,27015,40771,27015,1618,126,1492,4,31,2,2
45196,443,61474,443,6357,1546,4811,26,17,14,12
58057,80,12753,80,254,128,126,5,15,3,2
55107,53,13262,53,184,94,90,2,30,1,1
60434,445,0,0,70,70,0,1,0,1,0
63002,22114,0,0,66,66,0,1,0,1,0
11076,53,11076,53,832,106,726,2,30,1,1
56845,53,40181,53,730,102,628,2,30,1,1
57289,31573,0,0,62,62,0,1,0,1,0
49995,53,30507,53,197,102,95,2,33,1,1
64145,53,4283,53,177,94,83,2,31,1,1
64608,53,12446,53,212,110,102,2,30,1,1
60141,30188,0,0,66,66,0,1,0,1,0
30602,36237,0,0,146,146,0,1,0,1,0
49518,53,40851,53,167,86,81,2,30,1,1
58890,53,0,0,180,82,98,2,31,1,1
55497,53,23337,53,184,102,82,2,29,1,1
57987,56125,0,0,90,90,0,1,0,1,0
50380,443,13367,443,306,180,126,6,25,4,2
61718,443,31970,443,21125,2413,18712,42,49,20,22
56336,53,12124,53,196,102,94,2,30,1,1
49663,443,52474,443,8161,1929,6232,26,46,15,11
55417,445,0,0,70,70,0,1,0,1,0
51920,32678,45180,32678,70,70,0,2,8,2,0
56723,443,2144,443,7889,1900,5989,20,15,11,9
55198,445,0,0,70,70,0,1,0,1,0
60868,445,0,0,70,70,0,1,0,1,0
52064,43273,5722,43273,70,70,0,2,7,2,0
35498,80,39354,80,1270,387,883,16,392,4,12
55439,37965,0,0,66,66,0,1,0,1,0
23940,41615,0,0,146,146,0,1,0,1,0
7536,53,7536,53,198,90,108,2,30,1,1
50017,3389,50017,3389,3428,1714,1714,16,34,8,8
56176,53,42328,53,194,102,92,2,30,1,1
58892,445,0,0,70,70,0,1,0,1,0
56640,443,64695,443,7797,1808,5989,20,14,11,9
55688,53,48185,53,183,94,89,2,31,1,1
63154,443,63154,443,4642,1735,2907,19,30,11,8
56713,25174,0,0,62,62,0,1,0,1,0
3478,61463,0,0,1162,1162,0,1,0,1,0
58207,443,31795,443,10209,2530,7679,33,223,17,16
50279,443,26201,443,1128,654,474,17,18,10,7
25778,53,25778,53,235,90,145,2,33,1,1
5588,5588,0,0,3498,1872,1626,48,205,24,24
14752,53,14752,53,229,98,131,2,30,1,1
32804,80,61447,80,7454,2436,5018,26,23,16,10
55372,445,0,0,70,70,0,1,0,1,0
53554,8999,6458,8999,130,70,60,3,6,2,1
50542,445,0,0,66,66,0,1,0,1,0
41815,50265,0,0,146,146,0,1,0,1,0
56246,53,33774,53,209,110,99,2,30,1,1
64618,53,21647,53,198,102,96,2,30,1,1
64005,53,59576,53,402,125,277,4,37,2,2
55307,53,50101,53,1415,101,1314,4,51,2,2
49217,53,12085,53,202,103,99,2,31,1,1
56532,445,0,0,70,70,0,1,0,1,0
55834,445,0,0,66,66,0,1,0,1,0
65026,445,0,0,70,70,0,1,0,1,0
60297,445,0,0,70,70,0,1,0,1,0
60474,443,49891,443,5888,1175,4713,19,76,11,8
55146,445,0,0,70,70,0,1,0,1,0
61405,445,0,0,66,66,0,1,0,1,0
50746,443,7838,443,6354,1372,4982,18,161,9,9
47871,443,47202,443,70,70,0,1,5,1,0
58771,53,46484,53,168,78,90,2,30,1,1
61397,80,22347,80,2500,531,1969,11,75,6,5
55592,445,0,0,70,70,0,1,0,1,0
54093,5228,31167,5228,7608,1824,5784,34,171,19,15
56775,9200,31796,9200,8223,3066,5157,30,33,15,15
34228,45129,0,0,148,148,0,1,0,1,0
56945,443,12296,443,7818,2136,5682,31,322,14,17
46714,80,46714,80,83777,2610,81167,90,155,27,63
50,64147,0,0,62,62,0,1,0,1,0
53771,53,15804,53,168,78,90,2,30,1,1
54774,445,0,0,66,66,0,1,0,1,0
14360,64147,0,0,62,62,0,1,0,1,0
64420,53,21949,53,362,94,268,2,30,1,1
58728,445,0,0,70,70,0,1,0,1,0
14597,53,14597,53,404,259,145,3,32,2,1
40334,53,40334,53,213,87,126,2,30,1,1
53690,42301,12821,42301,1821,1088,733,17,15,9,8
6356,26467,0,0,62,62,0,1,0,1,0
55562,50584,0,0,66,66,0,1,0,1,0
49607,25174,0,0,66,66,0,1,0,1,0
57103,445,0,0,70,70,0,1,0,1,0
55332,53,45716,53,211,110,101,2,30,1,1
49633,53,1926,53,245,94,151,2,29,1,1
57249,443,12847,443,7965,2643,5322,42,15,24,18
53577,8999,47694,8999,372,186,186,6,15,3,3
64764,53,35102,53,211,102,109,2,30,1,1
56958,53,40535,53,193,102,91,2,30,1,1
63989,445,0,0,66,66,0,1,0,1,0
46286,21247,0,0,62,62,0,1,0,1,0
37335,443,52361,443,4734755,152171,4582584,5334,405,2083,3251
55859,53,0,0,82,82,0,1,30,1,0
49418,23333,56641,23333,244,71,173,2,30,1,1
55365,53,11222,53,214,110,104,2,29,1,1
55209,53,33482,53,196,102,94,2,33,1,1
57969,42873,0,0,66,66,0,1,0,1,0
63672,53,63672,53,198,90,108,2,30,1,1
49855,80,46269,80,41720,6568,35152,47,89,17,30
54236,445,0,0,70,70,0,1,0,1,0
43444,53,43444,53,314,98,216,2,30,1,1
51616,443,56570,443,62241,4598,57643,82,170,35,47
62352,445,0,0,70,70,0,1,0,1,0
50692,443,32817,443,180,60,120,4,15,2,2
60756,445,0,0,70,70,0,1,0,1,0
27724,53,46943,53,322,84,238,4,29,2,2
49601,53,44219,53,178,94,84,2,30,1,1
56119,445,0,0,70,70,0,1,0,1,0
723,3389,0,0,74,74,0,1,0,1,0
54360,443,26291,443,12260,3870,8390,52,283,27,25
50038,53,65055,53,286,87,199,4,59,2,2
49275,53,23304,53,212,102,110,2,30,1,1
48627,443,55025,443,638,70,568,10,207,2,8
33640,443,55083,443,10558,2530,8028,25,186,14,11
59933,80,6671,80,582,138,444,9,25,3,6
48754,443,18594,443,6490,1145,5345,20,33,11,9
56914,53,24598,53,821,102,719,2,30,1,1
55850,53,58369,53,816,97,719,2,30,1,1
57231,53,2071,53,168,86,82,2,31,1,1
46503,443,50192,443,6492,1764,4728,56,996,20,36
64036,53,20328,53,183,94,89,2,30,1,1
50561,445,0,0,70,70,0,1,0,1,0
1987,26467,0,0,62,62,0,1,0,1,0
63615,445,0,0,70,70,0,1,0,1,0
63387,445,0,0,66,66,0,1,0,1,0
39393,22114,0,0,146,146,0,1,0,1,0
46212,443,28562,443,190,70,120,4,15,2,2
51517,443,20075,443,590874,19818,571056,669,42,271,398
65359,445,0,0,70,70,0,1,0,1,0
53551,445,0,0,70,70,0,1,0,1,0
51196,445,0,0,70,70,0,1,0,1,0
40481,22114,0,0,66,66,0,1,0,1,0
64059,445,0,0,70,70,0,1,0,1,0
55346,53,62620,53,177,94,83,2,31,1,1
49751,53,48975,53,232,92,140,2,30,1,1
57461,445,0,0,66,66,0,1,0,1,0
10145,21247,0,0,62,62,0,1,0,1,0
50584,1070,63097,1070,161,161,0,2,1200,2,0
50993,445,0,0,66,66,0,1,0,1,0
53161,30013,56221,30013,70,70,0,1,5,1,0
59327,445,0,0,70,70,0,1,0,1,0
35494,22114,0,0,62,62,0,1,0,1,0
51547,443,7780,443,202,70,132,3,11,1,2
55275,445,0,0,70,70,0,1,0,1,0
55483,443,25400,443,4496,2369,2127,15,136,7,8
65501,57470,0,0,72,72,0,1,0,1,0
443,20087,0,0,83,83,0,1,0,1,0
27005,32066,2938,32066,881,126,755,2,31,1,1
64913,53,45280,53,188,96,92,2,30,1,1
49618,80,5688,80,314,192,122,6,42,4,2
56218,43890,0,0,62,62,0,1,0,1,0
55001,445,0,0,70,70,0,1,0,1,0
45941,23386,0,0,60,60,0,1,0,1,0
49443,80,19440,80,3642,1460,2182,23,143,12,11
43368,443,39927,443,190,70,120,4,15,2,2
49973,53,27114,53,261,94,167,2,30,1,1
58749,443,22893,443,6246,4267,1979,21,16,11,10
6882,50239,19851,50239,296,150,146,2,1200,1,1
49418,27001,35049,27001,256,78,178,2,30,1,1
50412,445,0,0,70,70,0,1,0,1,0
43488,443,22133,443,6817,1221,5596,26,285,14,12
43861,123,6210,123,184,94,90,2,29,1,1
6712,80,6712,80,514,246,268,9,82,5,4
56652,53,23903,53,821,102,719,2,30,1,1
60883,443,40215,443,11586,5435,6151,46,46,25,21
55945,53,48545,53,177,94,83,2,30,1,1
64332,53,40499,53,167,86,81,2,30,1,1
49598,80,32079,80,372,192,180,7,41,4,3
40489,1433,0,0,60,60,0,1,0,1,0
55694,53,54062,53,166,85,81,2,31,1,1
57721,443,65259,443,1019,644,375,10,37,6,4
56334,53,19616,53,177,94,83,2,30,1,1
45832,51050,0,0,62,62,0,1,0,1,0
1040,6004,0,0,72,72,0,1,0,1,0
53247,445,0,0,70,70,0,1,0,1,0
59044,445,0,0,70,70,0,1,0,1,0
60413,43555,1703,43555,70,70,0,1,5,1,0
17408,8497,0,0,148,148,0,1,0,1,0
52823,445,0,0,70,70,0,1,0,1,0
63763,17368,13988,17368,66,66,0,2,8,2,0
54989,443,11421,443,34038,16039,17999,79,63,43,36
65042,53,41893,53,182,93,89,2,31,1,1
55010,445,0,0,70,70,0,1,0,1,0
43686,443,17205,443,6804,914,5890,22,257,10,12
49418,30003,43016,30003,71,71,0,1,30,1,0
53144,443,6960,443,7121,2564,4557,26,127,15,11
49471,80,33120,80,10175,1359,8816,18,78,7,11
55377,3389,55377,3389,3343,1454,1889,15,16,8,7
7701,23,0,0,60,60,0,1,0,1,0
62654,35440,0,0,62,62,0,1,0,1,0
26782,443,49572,443,7407,2650,4757,24,20,12,12
61184,445,0,0,70,70,0,1,0,1,0
57917,44847,0,0,66,66,0,1,0,1,0
65322,53,28599,53,395,102,293,2,30,1,1
56594,53,50396,53,165,86,79,2,29,1,1
47831,53,0,0,86,86,0,1,30,1,0
55424,38303,0,0,66,66,0,1,0,1,0
54773,50584,0,0,62,62,0,1,0,1,0
57239,5228,64844,5228,16135,7514,8621,173,9115,72,101
63220,445,0,0,70,70,0,1,0,1,0
49486,53,33759,53,170,87,83,2,31,1,1
56052,53,22562,53,177,94,83,2,30,1,1
2437,23117,0,0,62,62,0,1,0,1,0
55118,445,0,0,70,70,0,1,0,1,0
56785,39004,0,0,145,145,0,1,0,1,0
5223,22981,0,0,60,60,0,1,0,1,0
55802,443,44281,443,30007,2755,27252,41,136,16,25
64791,53,42823,53,184,94,90,2,31,1,1
57827,443,29156,443,912754,34972,877782,1035,294,410,625
443,43990,0,0,74,74,0,1,0,1,0
49743,445,0,0,70,70,0,1,0,1,0
55352,53,35227,53,216,110,106,2,30,1,1
43029,443,37384,443,6053,1321,4732,19,980,9,10
25031,25174,0,0,146,146,0,1,0,1,0
63964,53,52901,53,196,94,102,2,30,1,1
49818,37965,0,0,62,62,0,1,0,1,0
54646,445,0,0,70,70,0,1,0,1,0
34365,443,34038,443,223826,45909,177917,356,44,176,180
64257,53,1307,53,168,86,82,2,30,1,1
53876,53380,47868,53380,70,70,0,1,5,1,0
55466,445,0,0,66,66,0,1,0,1,0
5087,22114,0,0,66,66,0,1,0,1,0
64608,53,18292,53,212,110,102,2,30,1,1
27005,27111,30399,27111,893,126,767,2,30,1,1
55425,5222,24173,5222,9151,4417,4734,84,77,44,40
65241,53,22089,53,200,102,98,2,31,1,1
59738,443,4655,443,510,164,346,2,31,1,1
64505,53,32135,53,214,102,112,2,30,1,1
51414,22,0,0,60,60,0,1,0,1,0
56752,443,27500,443,11771,2624,9147,50,20,25,25
39402,443,48958,443,6417,1255,5162,24,360,12,12
54889,53,54889,53,832,106,726,2,30,1,1
61304,443,62811,443,8594,1042,7552,16,120,7,9
65196,445,0,0,66,66,0,1,0,1,0
56411,80,44029,80,35574,868,34706,36,104,10,26
50269,443,40163,443,7543,2533,5010,26,55,14,12
60425,80,53766,80,186,64,122,4,28,2,2
57470,61768,42520,61768,330,330,0,6,1199,6,0
49828,443,7626,443,1737,1158,579,16,74,10,6
53906,44512,0,0,62,62,0,1,0,1,0
63314,57470,0,0,66,66,0,1,0,1,0
58276,43890,0,0,66,66,0,1,0,1,0
44586,443,61467,443,122708,5797,116911,169,132,75,94
64214,53,1437,53,337,106,231,4,43,2,2
30960,45750,9630,45750,66,66,0,1,3600,1,0
55609,53,45313,53,172,88,84,2,30,1,1
58813,445,0,0,70,70,0,1,0,1,0
51904,445,0,0,70,70,0,1,0,1,0
50864,443,25636,443,6391,1285,5106,19,15,10,9
57417,53,7685,53,199,102,97,2,30,1,1
62768,443,53717,443,30902,6307,24595,86,269,36,50
49826,53,43562,53,466,192,274,6,83,3,3
50336,80,50336,80,2143,676,1467,12,25,7,5
27005,27015,15191,27015,889,126,763,2,30,1,1
57987,56125,0,0,90,90,0,1,0,1,0
49266,53,6643,53,199,102,97,2,29,1,1
57201,53,40982,53,214,110,104,2,29,1,1
51311,22,51311,22,5624,2099,3525,30,23,17,13
56620,53,31427,53,216,110,106,2,30,1,1
56511,53,19992,53,200,102,98,2,31,1,1
51081,53,49643,53,168,78,90,2,30,1,1
55543,445,0,0,70,70,0,1,0,1,0
58638,5900,0,0,62,62,0,1,0,1,0
56891,53,55899,53,226,110,116,2,30,1,1
49609,80,24955,80,11534,719,10815,18,61,7,11
45963,443,45963,443,4592,1685,2907,19,27,11,8
51842,443,3576,443,1503,984,519,13,31,8,5
56997,53,62280,53,86,86,0,1,30,1,0
49242,445,0,0,70,70,0,1,0,1,0
58483,443,25541,443,3024,709,2315,13,120,6,7
3792,52700,0,0,62,62,0,1,0,1,0
61207,445,0,0,66,66,0,1,0,1,0
37567,443,51638,443,13774,4989,8785,35,51,20,15
57260,51221,0,0,66,66,0,1,0,1,0
64997,51221,0,0,66,66,0,1,0,1,0
53983,40500,52248,40500,70,70,0,2,7,2,0
58946,445,0,0,70,70,0,1,0,1,0
55198,80,49692,80,41822,2038,39784,56,15,27,29
33196,443,16510,443,6989,5073,1916,24,111,14,10
65304,53,18529,53,209,110,99,2,30,1,1
3730,17372,0,0,62,62,0,1,0,1,0
37815,443,28606,443,6226,4834,1392,17,125,11,6
60166,443,54772,443,7639,2673,4966,36,255,17,19
58780,443,38855,443,8661,1687,6974,30,244,16,14
55404,445,0,0,70,70,0,1,0,1,0
56900,445,0,0,66,66,0,1,0,1,0
5773,53,5773,53,229,90,139,2,30,1,1
55504,445,0,0,66,66,0,1,0,1,0
56376,44847,0,0,66,66,0,1,0,1,0
56320,53,53146,53,183,94,89,2,30,1,1
15875,50584,0,0,62,62,0,1,0,1,0
33649,123,62077,123,184,94,90,2,30,1,1
51652,80,52729,80,32942,2548,30394,58,255,28,30
54300,22114,0,0,62,62,0,1,0,1,0
33415,53,42301,53,164,78,86,2,29,1,1
49352,53,48466,53,214,94,120,2,30,1,1
49913,53,50642,53,216,110,106,2,31,1,1
58638,5900,0,0,62,62,0,1,0,1,0
51465,443,37534,443,318,70,248,5,17,1,4
65498,53,49564,53,749,94,655,2,30,1,1
57259,53,43508,53,199,102,97,2,30,1,1
55244,53,5418,53,186,102,84,2,29,1,1
50635,53,9293,53,199,94,105,2,30,1,1
60150,445,0,0,70,70,0,1,0,1,0
40620,443,2727,443,7049,1412,5637,24,16,14,10
62071,22114,0,0,62,62,0,1,0,1,0
37567,443,17651,443,499,425,74,4,0,3,1
50391,445,0,0,66,66,0,1,0,1,0
52687,445,0,0,70,70,0,1,0,1,0
65317,80,47905,80,1014,507,507,8,133,5,3
58777,445,0,0,70,70,0,1,0,1,0
39616,443,20055,443,60,60,0,2,5,2,0
64318,53,45436,53,183,94,89,2,30,1,1
59583,445,0,0,70,70,0,1,0,1,0
49243,53,19778,53,212,102,110,2,30,1,1
55660,443,55660,443,51312,5706,45606,77,48,38,39
63975,24874,47562,24874,70,70,0,1,5,1,0
50265,49754,28018,49754,402,132,270,6,1209,3,3
58638,5900,0,0,62,62,0,1,0,1,0
51073,445,0,0,66,66,0,1,0,1,0
63527,50584,0,0,66,66,0,1,0,1,0
57987,56125,0,0,90,90,0,1,0,1,0
6832,51505,0,0,66,66,0,1,0,1,0
56288,53,3353,53,200,102,98,2,30,1,1
35122,80,19351,80,130,70,60,2,15,1,1
50440,53,39485,53,216,110,106,2,30,1,1
5223,21557,0,0,91,91,0,1,0,1,0
36881,56205,0,0,62,62,0,1,0,1,0
65375,443,53764,443,2458316,102393,2355923,2942,241,1261,1681
53571,445,0,0,70,70,0,1,0,1,0
27539,25174,0,0,146,146,0,1,0,1,0
14082,50584,0,0,66,66,0,1,0,1,0
49413,443,7382,443,44505,6962,37543,64,48,21,43
58597,35440,0,0,62,62,0,1,0,1,0
55965,53,22177,53,184,94,90,2,30,1,1
52203,1024,52908,1024,136,136,0,3,14,3,0
27005,12345,8943,12345,898,126,772,2,31,1,1
57546,25174,0,0,66,66,0,1,0,1,0
40400,22114,0,0,62,62,0,1,0,1,0
56799,443,47229,443,8021,2001,6020,20,15,11,9
54992,53,62120,53,195,102,93,2,30,1,1
57316,53,57316,53,216,82,134,2,32,1,1
54752,31573,0,0,66,66,0,1,0,1,0
0,0,0,0,156,156,0,2,0,2,0
61945,48817,0,0,62,62,0,1,0,1,0
49261,53,20112,53,453,186,267,6,30,3,3
61919,445,0,0,70,70,0,1,0,1,0
51212,445,0,0,66,66,0,1,0,1,0
9473,26467,0,0,66,66,0,1,0,1,0
58703,445,0,0,70,70,0,1,0,1,0
49468,443,51693,443,6940,1302,5638,20,119,10,10
46592,53,27919,53,168,78,90,2,30,1,1
57149,445,0,0,70,70,0,1,0,1,0
123,123,26744,123,184,94,90,2,30,1,1
64872,53,23783,53,323,94,229,2,30,1,1
56722,80,63327,80,41658,23230,18428,114,798,66,48
17750,6881,6103,6881,149,149,0,1,1200,1,0
53479,80,7819,80,3307,937,2370,17,16,10,7
63855,80,40243,80,4529,1221,3308,14,75,8,6
27005,27019,53599,27019,881,126,755,2,30,1,1
50200,44847,0,0,74,74,0,1,0,1,0
52108,445,0,0,66,66,0,1,0,1,0
42898,43890,0,0,62,62,0,1,0,1,0
58625,445,0,0,66,66,0,1,0,1,0
55395,53,45676,53,767,102,665,2,31,1,1
53974,443,28676,443,3330,1694,1636,15,30,8,7
26921,57470,0,0,62,62,0,1,0,1,0
59938,445,0,0,70,70,0,1,0,1,0
50602,53,48380,53,761,100,661,2,30,1,1
65507,53,53628,53,199,102,97,2,30,1,1
43549,443,50179,443,10316,2303,8013,39,120,20,19
55002,53,42728,53,196,102,94,2,31,1,1
51096,63710,0,0,62,62,0,1,0,1,0
53881,11513,24027,11513,320,140,180,6,5,3,3
57899,443,40248,443,6115,1035,5080,21,170,11,10
54967,53,27983,53,178,94,84,2,30,1,1
17811,23,0,0,60,60,0,1,0,1,0
62080,54532,0,0,60,60,0,1,0,1,0
52640,6881,33244,6881,719,413,306,10,14,5,5
65494,53,0,0,88,88,0,1,0,1,0
60839,445,0,0,66,66,0,1,0,1,0
26900,27017,35787,27017,422,164,258,6,29,3,3
58877,53,28014,53,426,118,308,2,31,1,1
50600,53,50600,53,257,101,156,2,34,1,1
6881,13487,50124,13487,228,118,110,2,1199,1,1
52295,53,54282,53,322,102,220,2,30,1,1
54910,445,0,0,66,66,0,1,0,1,0
49418,27017,46358,27017,252,71,181,2,30,1,1
50355,43890,0,0,66,66,0,1,0,1,0
49313,53,49710,53,199,102,97,2,30,1,1
63020,443,53282,443,512,166,346,2,30,1,1
55955,53,35067,53,184,94,90,2,31,1,1
53807,445,0,0,70,70,0,1,0,1,0
59679,37807,0,0,66,66,0,1,0,1,0
64894,53,19330,53,195,102,93,2,30,1,1
41059,443,46382,443,1248874,30382,1218492,1261,111,425,836
48894,53,34771,53,164,78,86,2,31,1,1
55622,33342,63556,33342,70,70,0,2,8,2,0
65037,53,41367,53,210,110,100,2,29,1,1
49827,443,4607,443,21625,7638,13987,45,48,24,21
55810,80,19012,80,11093,1415,9678,18,18,8,10
39453,15503,0,0,74,74,0,1,0,1,0
60708,53,53667,53,291,86,205,2,29,1,1
61800,445,0,0,66,66,0,1,0,1,0
49639,53,29692,53,250,102,148,2,29,1,1
59647,47993,0,0,62,62,0,1,0,1,0
57090,51505,0,0,66,66,0,1,0,1,0
56177,53,3037,53,807,94,713,2,31,1,1
59523,37965,0,0,62,62,0,1,0,1,0
49554,80,58941,80,1515,481,1034,11,15,6,5
49492,80,50602,80,1680,1210,470,9,15,5,4
35742,53,48792,53,199,94,105,2,30,1,1
47820,443,39799,443,1132,596,536,17,28,9,8
52745,443,60430,443,19919,2270,17649,38,26,21,17
21534,42246,0,0,66,66,0,1,0,1,0
25412,23,0,0,60,60,0,1,0,1,0
58753,445,0,0,66,66,0,1,0,1,0
50865,53,50865,53,242,98,144,2,30,1,1
56091,53,32743,53,738,86,652,2,31,1,1
55660,42459,61425,42459,1717,1129,588,17,25,10,7
52274,443,52274,443,6679,2408,4271,23,20,10,13
57426,66,63838,66,70,70,0,1,5,1,0
50325,80,28914,80,19438,12019,7419,53,312,30,23
56176,53,4646,53,188,96,92,2,30,1,1
49667,53,65196,53,183,94,89,2,30,1,1
45973,80,60960,80,1114,534,580,12,16,7,5
55165,53,23562,53,193,102,91,2,29,1,1
36754,443,35340,443,1320,822,498,16,41,9,7
50477,443,26806,443,55388,4069,51319,94,240,46,48
64000,44847,0,0,62,62,0,1,0,1,0
59043,35440,0,0,66,66,0,1,0,1,0
14605,53,14605,53,209,77,132,2,32,1,1
50263,53,58515,53,771,102,669,2,30,1,1
60607,53,60607,53,832,106,726,2,30,1,1
47376,443,12829,443,2944,778,2166,10,120,5,5
64338,443,59182,443,1786,172,1614,7,120,3,4
61466,443,43127,443,6205,1125,5080,23,89,13,10
35357,53,47462,53,291,86,205,2,29,1,1
60987,445,0,0,70,70,0,1,0,1,0
61183,25174,0,0,62,62,0,1,0,1,0
53161,30013,6313,30013,70,70,0,2,7,2,0
49761,80,17829,80,2113,1181,932,10,127,6,4
58638,5900,0,0,62,62,0,1,0,1,0
56828,445,0,0,70,70,0,1,0,1,0
57603,443,1218,443,2614,1689,925,18,23,10,8
52128,80,31768,80,366,240,126,7,26,5,2
55868,53,18445,53,177,94,83,2,30,1,1
58445,17500,0,0,66,66,0,1,0,1,0
50137,445,0,0,70,70,0,1,0,1,0
65343,53,9995,53,197,102,95,2,30,1,1
56883,53,30894,53,184,94,90,2,29,1,1
59693,443,23790,443,1867,250,1617,8,120,4,4
43435,5228,26335,5228,6668,1369,5299,20,3600,10,10
55335,445,0,0,70,70,0,1,0,1,0
50647,443,3164,443,3201,1812,1389,15,19,9,6
54612,445,0,0,70,70,0,1,0,1,0
65246,53,13640,53,767,102,665,2,30,1,1
49707,80,15833,80,196092,6387,189705,189,108,57,132
56752,53,57000,53,182,93,89,2,30,1,1
49874,53,62950,53,196,94,102,2,30,1,1
5588,5588,0,0,3354,1792,1562,46,194,23,23
60715,80,28604,80,198,78,120,4,11,2,2
50501,123,36469,123,184,94,90,2,30,1,1
1638,22114,0,0,62,62,0,1,0,1,0
53377,445,0,0,70,70,0,1,0,1,0
64982,53,19403,53,190,97,93,2,31,1,1
52557,44847,0,0,62,62,0,1,0,1,0
49740,53,20655,53,793,101,692,2,31,1,1
46970,443,52704,443,8394,3155,5239,28,271,16,12
52741,445,0,0,70,70,0,1,0,1,0
65216,53,41251,53,292,94,198,2,30,1,1
56126,53,16372,53,774,101,673,2,31,1,1
49800,53,35452,53,485,93,392,4,48,2,2
32707,11392,0,0,146,146,0,1,0,1,0
55796,53,36094,53,196,102,94,2,30,1,1
51974,54759,44030,54759,70,70,0,2,7,2,0
27005,27016,21347,27016,902,126,776,2,30,1,1
5637,37965,0,0,62,62,0,1,0,1,0
58343,445,0,0,70,70,0,1,0,1,0
53206,80,36804,80,2622,1074,1548,14,282,8,6
56497,80,9145,80,410119,16112,394007,424,63,155,269
59779,445,0,0,70,70,0,1,0,1,0
56174,443,38355,443,18931,4924,14007,46,139,20,26
64024,57470,0,0,66,66,0,1,0,1,0
53872,443,24185,443,499,425,74,4,1,3,1
59310,445,0,0,66,66,0,1,0,1,0
13588,15503,0,0,62,62,0,1,0,1,0
49772,53,60667,53,178,91,87,2,30,1,1
63676,445,0,0,70,70,0,1,0,1,0
64261,53,48738,53,295,110,185,2,30,1,1
54234,53,54234,53,237,91,146,2,33,1,1
36811,53,36811,53,227,90,137,2,29,1,1
13168,35440,0,0,62,62,0,1,0,1,0
24931,25174,0,0,62,62,0,1,0,1,0
54089,445,0,0,66,66,0,1,0,1,0
55461,53,48907,53,198,110,88,2,31,1,1
58039,80,32642,80,318,192,126,6,21,4,2
1264,26296,0,0,143,143,0,1,0,1,0
53389,23,0,0,60,60,0,1,0,1,0
52004,55711,7662,55711,70,70,0,1,5,1,0
57218,445,0,0,66,66,0,1,0,1,0
55975,53,44915,53,195,102,93,2,31,1,1
35112,8635,35112,8635,138,78,60,2,5,1,1
34417,53,11898,53,168,78,90,2,30,1,1
48203,80,21963,80,946,531,415,11,315,6,5
62197,445,0,0,70,70,0,1,0,1,0
58638,5900,0,0,62,62,0,1,0,1,0
61612,445,0,0,70,70,0,1,0,1,0
56733,53,5625,53,183,94,89,2,30,1,1
58745,30188,0,0,66,66,0,1,0,1,0
13120,25174,0,0,62,62,0,1,0,1,0
41348,5555,0,0,60,60,0,1,0,1,0
47210,50584,0,0,146,146,0,1,0,1,0
50265,16082,44635,16082,858,858,0,14,1200,14,0
59124,443,18887,443,9612,1720,7892,32,130,15,17
31593,53,31593,53,832,106,726,2,30,1,1
55897,53,23504,53,770,102,668,2,30,1,1
53939,445,0,0,66,66,0,1,0,1,0
50613,80,37228,80,21942,2323,19619,28,21,11,17
55019,443,34089,443,12411,7888,4523,33,17,19,14
58016,80,61881,80,378,192,186,7,21,4,3
63364,57470,0,0,62,62,0,1,0,1,0
55856,445,0,0,70,70,0,1,0,1,0
57538,23,0,0,60,60,0,1,0,1,0
50374,443,25596,443,4749,859,3890,18,30,9,9
65028,53,18830,53,182,93,89,2,30,1,1
38163,53,38163,53,216,89,127,2,30,1,1
56812,49600,3950,49600,3060,1569,1491,12,16,7,5
49818,445,0,0,70,70,0,1,0,1,0
63385,443,63385,443,4659,1752,2907,19,30,11,8
57863,445,0,0,66,66,0,1,0,1,0
50511,445,0,0,70,70,0,1,0,1,0
36008,80,27818,80,1614,1300,314,10,15,5,5
5222,18733,0,0,66,66,0,1,0,1,0
50683,445,0,0,70,70,0,1,0,1,0
59890,445,0,0,70,70,0,1,0,1,0
443,49988,0,0,82,82,0,1,0,1,0
53880,61393,8542,61393,320,140,180,6,6,3,3
61051,445,0,0,70,70,0,1,0,1,0
43161,443,23414,443,10102,3072,7030,25,16,14,11
49339,80,8376,80,1467,361,1106,10,15,5,5
57470,5382,65418,5382,2411,1328,1083,19,1200,11,8
51650,80,36691,80,141348,4210,137138,161,17,58,103
64467,53,16595,53,184,94,90,2,31,1,1
45837,443,61728,443,39986,3118,36868,72,82,30,42
50910,80,20207,80,14877069,179445,14697624,12450,135,2531,9919
52318,443,6808,443,9453,2797,6656,46,32,25,21
61202,35894,0,0,66,66,0,1,0,1,0
63178,445,0,0,66,66,0,1,0,1,0
35937,25174,0,0,66,66,0,1,0,1,0
56772,61424,62775,61424,66,66,0,1,5,1,0
50265,63104,28604,63104,330,330,0,6,1200,6,0
64041,53,11407,53,200,102,98,2,31,1,1
54267,53,33061,53,86,86,0,1,30,1,0
49336,25174,0,0,66,66,0,1,0,1,0
61635,37965,0,0,66,66,0,1,0,1,0
51151,64147,0,0,62,62,0,1,0,1,0
49790,445,0,0,66,66,0,1,0,1,0
41011,443,63172,443,175097,9838,165259,244,106,120,124
50817,53,0,0,182,73,109,2,30,1,1
53072,445,0,0,66,66,0,1,0,1,0
50049,443,7528,443,27889,1445,26444,37,121,14,23
55199,21247,0,0,66,66,0,1,0,1,0
54025,443,49847,443,7653,1188,6465,21,16,12,9
48420,54532,0,0,146,146,0,1,0,1,0
56628,53,54812,53,789,110,679,2,30,1,1
45344,53,14086,53,538,328,210,3,29,2,1
54035,443,14205,443,4454,2001,2453,11,120,6,5
57028,445,0,0,70,70,0,1,0,1,0
55617,53,58686,53,196,94,102,2,30,1,1
57140,53,49322,53,177,94,83,2,30,1,1
57265,53,26246,53,762,98,664,2,30,1,1
50512,1212,0,0,145,145,0,1,0,1,0
52782,445,0,0,66,66,0,1,0,1,0
57443,443,31881,443,8287,2469,5818,31,18,14,17
55383,445,0,0,70,70,0,1,0,1,0
62255,445,0,0,70,70,0,1,0,1,0
52341,445,0,0,66,66,0,1,0,1,0
64486,445,0,0,70,70,0,1,0,1,0
33502,5529,0,0,143,143,0,1,0,1,0
62337,443,30628,443,3908576,93181,3815395,3743,56,1160,2583
56658,53,11385,53,186,95,91,2,31,1,1
53651,47758,20351,47758,70,70,0,2,7,2,0
58791,25174,0,0,146,146,0,1,0,1,0
64782,53,60235,53,212,102,110,2,29,1,1
7000,23117,0,0,62,62,0,1,0,1,0
55658,443,55658,443,26504,10384,16120,58,48,37,21
57238,53,18077,53,701,88,613,2,31,1,1
57317,443,9547,443,5614,733,4881,16,15,9,7
21133,17068,30422,17068,481,150,331,2,1199,1,1
64359,53,62943,53,196,102,94,2,30,1,1
56183,445,0,0,70,70,0,1,0,1,0
6881,6881,56597,6881,231,111,120,2,1200,1,1
54827,50432,0,0,109,109,0,1,0,1,0
30960,45700,20531,45700,330,330,0,6,3609,6,0
54173,445,0,0,70,70,0,1,0,1,0
10910,57866,0,0,62,62,0,1,0,1,0
20706,23718,0,0,62,62,0,1,0,1,0
49997,53,42691,53,209,110,99,2,29,1,1
57598,443,10245,443,12463,6762,5701,28,31,14,14
49163,443,41945,443,2529,1230,1299,17,16,9,8
56429,53,7462,53,762,98,664,2,31,1,1
30129,37965,0,0,72,72,0,1,0,1,0
64617,445,0,0,70,70,0,1,0,1,0
53599,445,0,0,70,70,0,1,0,1,0
58638,5900,0,0,62,62,0,1,0,1,0
50278,443,27147,443,259911,11421,248490,336,92,144,192
55462,445,0,0,70,70,0,1,0,1,0
52994,443,57845,443,10694,4129,6565,41,111,20,21
53248,443,60652,443,532222,22112,510110,645,232,259,386
51001,53,26424,53,183,86,97,2,30,1,1
57470,51413,17602,51413,330,330,0,6,1199,6,0
38234,443,15725,443,9807,2542,7265,47,19,24,23
52734,445,0,0,70,70,0,1,0,1,0
50967,443,6506,443,612314,25589,586725,676,127,234,442
56382,53,19333,53,190,97,93,2,31,1,1
40471,80,40471,80,1917,1468,449,10,20,6,4
50106,31573,0,0,66,66,0,1,0,1,0
50672,80,6037,80,1718,1247,471,9,14,5,4
35408,53,57895,53,168,78,90,2,30,1,1
58638,5900,0,0,62,62,0,1,0,1,0
57196,53,25390,53,183,94,89,2,30,1,1
49260,53,23458,53,199,86,113,2,30,1,1
49637,53,0,0,86,86,0,1,30,1,0
63846,443,9201,443,3811,1538,2273,20,135,10,10
37168,5900,0,0,60,60,0,1,0,1,0
53606,54476,23615,54476,320,140,180,6,6,3,3
55715,53,18469,53,168,86,82,2,30,1,1
57015,42707,0,0,62,62,0,1,0,1,0
50691,80,62082,80,4237,3610,627,15,31,8,7
55545,445,0,0,70,70,0,1,0,1,0
58027,445,0,0,70,70,0,1,0,1,0
24972,27262,0,0,60,60,0,1,0,1,0
50883,80,64742,80,204646,11741,192905,240,141,104,136
55707,53,31512,53,177,94,83,2,30,1,1
55166,445,0,0,70,70,0,1,0,1,0
57912,443,23938,443,7953,5153,2800,33,142,19,14
65211,53,54701,53,183,94,89,2,30,1,1
49456,443,44613,443,939,547,392,11,27,5,6
52210,51505,0,0,66,66,0,1,0,1,0
42298,443,6175,443,70,70,0,1,30,1,0
60248,46776,0,0,66,66,0,1,0,1,0
50520,80,14281,80,1615,793,822,13,91,7,6
48728,443,2946,443,2437,1321,1116,15,83,9,6
50998,445,0,0,70,70,0,1,0,1,0
52180,20121,52199,20121,70,70,0,2,7,2,0
51340,445,0,0,70,70,0,1,0,1,0
55036,443,41925,443,10001,2547,7454,27,35,14,13
57607,21247,0,0,66,66,0,1,0,1,0
55300,445,0,0,70,70,0,1,0,1,0
57396,443,55887,443,1054,567,487,10,24,6,4
65516,53,20089,53,506,204,302,6,57,3,3
52106,41632,33294,41632,66,66,0,1,5,1,0
55855,445,0,0,70,70,0,1,0,1,0
59899,3389,59899,3389,3504,1790,1714,17,32,9,8
34993,15503,0,0,62,62,0,1,0,1,0
49175,2710,9134,2710,66,66,0,1,5,1,0
37075,80,59950,80,1597,783,814,10,15,5,5
53693,445,0,0,70,70,0,1,0,1,0
50360,80,38167,80,5307,2694,2613,17,25,9,8
49516,53,42173,53,183,94,89,2,30,1,1
58008,80,56721,80,2549,1595,954,21,75,11,10
55367,53,11900,53,195,102,93,2,30,1,1
64578,53,53350,53,186,95,91,2,31,1,1
23514,53,23514,53,245,98,147,2,30,1,1
48861,53,40652,53,164,78,86,2,30,1,1
52493,443,57807,443,32907,8900,24007,38,16,16,22
41821,80,46291,80,1056,362,694,10,49,6,4
56626,80,44276,80,234,234,0,4,12,4,0
9237,80,59192,80,378,192,186,7,26,4,3
57397,53,24712,53,183,94,89,2,30,1,1
57940,445,0,0,70,70,0,1,0,1,0
58638,5900,0,0,62,62,0,1,0,1,0
50631,80,34721,80,14784,7048,7736,31,27,18,13
51651,80,41220,80,8100,4781,3319,23,166,12,11
6881,50321,40130,50321,238,118,120,2,1199,1,1
44821,64147,0,0,62,62,0,1,0,1,0
50606,443,59722,443,1511,849,662,16,94,9,7
41832,5222,27749,5222,3823,1878,1945,39,309,22,17
56532,445,0,0,66,66,0,1,0,1,0
45964,59999,45964,59999,60,60,0,1,5,1,0
37566,443,61835,443,1386,924,462,12,30,7,5
59214,57866,0,0,66,66,0,1,0,1,0
62126,445,0,0,70,70,0,1,0,1,0
58754,445,0,0,66,66,0,1,0,1,0
65085,445,0,0,70,70,0,1,0,1,0
64798,53,7114,53,178,94,84,2,30,1,1
55457,443,34189,443,130,70,60,3,5,2,1
63895,44847,0,0,62,62,0,1,0,1,0
56610,80,6975,80,1604,700,904,15,116,7,8
64554,53,13352,53,199,102,97,2,29,1,1
58564,50432,0,0,66,66,0,1,0,1,0
61886,445,0,0,70,70,0,1,0,1,0
55675,49271,26954,49271,504,318,186,8,16,5,3
56307,445,0,0,66,66,0,1,0,1,0
50972,3544,28007,3544,258,107,151,2,31,1,1
51164,445,0,0,70,70,0,1,0,1,0
54846,445,0,0,70,70,0,1,0,1,0
45944,443,12806,443,4715,1935,2780,24,183,11,13
55945,53,49702,53,177,94,83,2,31,1,1
54234,443,2984,443,499,425,74,4,0,3,1
50433,53,29987,53,193,102,91,2,30,1,1
45767,80,42626,80,2768,1722,1046,17,20,8,9
36357,25174,0,0,66,66,0,1,0,1,0
56260,53,19443,53,177,94,83,2,30,1,1
62905,443,5789,443,8426,2893,5533,27,16,15,12
51414,22,0,0,60,60,0,1,0,1,0
53019,443,6559,443,30012,3461,26551,72,93,28,44
6437,53,6437,53,229,90,139,2,30,1,1
52164,42271,30250,42271,70,70,0,2,8,2,0
55049,445,0,0,70,70,0,1,0,1,0
1968,23,0,0,60,60,0,1,0,1,0
49629,53,2341,53,198,102,96,2,29,1,1
54811,445,0,0,70,70,0,1,0,1,0
50607,445,0,0,66,66,0,1,0,1,0
17038,36829,0,0,146,146,0,1,0,1,0
64230,53,48297,53,193,94,99,2,30,1,1
52003,44512,0,0,66,66,0,1,0,1,0
51974,80,47213,80,38272,2881,35391,54,54,26,28
8380,80,8380,80,25613,1592,24021,32,22,9,23
56995,80,29664,80,214,140,74,4,35,3,1
65529,53,2543,53,199,102,97,2,30,1,1
56661,53,3079,53,297,102,195,4,34,2,2
47168,15000,16770,15000,130,70,60,2,5,1,1
57914,445,0,0,66,66,0,1,0,1,0
52602,445,0,0,70,70,0,1,0,1,0
54310,80,7871,80,552,280,272,9,30,5,4
34014,80,56105,80,1951,731,1220,11,150,6,5
50023,53,26218,53,166,86,80,2,31,1,1
64961,27025,27939,27025,1334,462,872,4,30,2,2
49903,445,0,0,70,70,0,1,0,1,0
64746,53,11815,53,186,95,91,2,31,1,1
50621,443,42624,443,10905,4352,6553,30,18,18,12
65469,53,34501,53,195,102,93,2,29,1,1
56362,53,49796,53,190,97,93,2,31,1,1
52263,16350,50284,16350,70,70,0,2,8,2,0
63379,36237,0,0,66,66,0,1,0,1,0
39098,51505,0,0,62,62,0,1,0,1,0
58006,443,30394,443,9596,1688,7908,26,255,13,13
60796,40010,42755,40010,316,136,180,6,7,3,3
59404,443,10904,443,2962,1844,1118,16,15,8,8
6881,6881,7756,6881,501,150,351,2,1200,1,1
62813,25174,0,0,62,62,0,1,0,1,0
51965,445,0,0,70,70,0,1,0,1,0
56532,53,25649,53,193,102,91,2,30,1,1
55032,62413,0,0,66,66,0,1,0,1,0
51339,445,0,0,70,70,0,1,0,1,0
59812,443,39961,443,6412,1530,4882,24,255,11,13
47962,16069,0,0,62,62,0,1,0,1,0
51132,445,0,0,70,70,0,1,0,1,0
59795,443,6313,443,120014,7352,112662,155,37,64,91
39063,44847,0,0,66,66,0,1,0,1,0
52198,445,0,0,70,70,0,1,0,1,0
56964,53,45347,53,267,87,180,4,54,2,2
39839,443,5588,443,5829,1408,4421,21,188,11,10
46331,53,26643,53,199,94,105,2,30,1,1
58093,445,0,0,70,70,0,1,0,1,0
56822,53,60516,53,184,94,90,2,30,1,1
27005,27999,8243,27999,913,126,787,2,31,1,1
50267,80,27570,80,12364,548,11816,17,46,6,11
53479,23,0,0,60,60,0,1,0,1,0
3375,35253,0,0,66,66,0,1,0,1,0
41803,53,41803,53,243,104,139,2,30,1,1
53773,15459,13024,15459,70,70,0,2,7,2,0
54819,443,17467,443,70,70,0,1,4,1,0
54664,443,62017,443,175780,7700,168080,196,36,78,118
53431,445,0,0,70,70,0,1,0,1,0
56434,53,6758,53,701,88,613,2,31,1,1
52916,445,0,0,66,66,0,1,0,1,0
52304,445,0,0,70,70,0,1,0,1,0
57432,53,25990,53,193,102,91,2,30,1,1
42300,53,40798,53,168,78,90,2,29,1,1
59178,53,27947,53,260,86,174,2,30,1,1
55163,53,9459,53,197,102,95,2,30,1,1
57750,37965,0,0,62,62,0,1,0,1,0
19245,64147,0,0,66,66,0,1,0,1,0
62902,32468,0,0,66,66,0,1,0,1,0
38761,123,12089,123,184,94,90,2,30,1,1
56402,53,29838,53,322,134,188,2,30,1,1
28441,23,28441,23,152,66,86,2,7,1,1
48778,443,13282,443,6770,2047,4723,26,16,14,12
65325,53,33633,53,216,110,106,2,29,1,1
62208,443,62208,443,4497,1590,2907,19,29,11,8
52179,14354,22942,14354,70,70,0,1,5,1,0
56231,53,14277,53,268,94,174,2,30,1,1
59534,445,0,0,66,66,0,1,0,1,0
58933,80,48784,80,2055,1651,404,8,76,5,3
51416,445,0,0,70,70,0,1,0,1,0
57339,57470,0,0,66,66,0,1,0,1,0
53233,445,0,0,70,70,0,1,0,1,0
56680,8100,35918,8100,78,78,0,1,5,1,0
6916,9822,0,0,100,100,0,1,0,1,0
46676,443,54715,443,16425,3923,12502,37,156,19,18
53105,42707,0,0,66,66,0,1,0,1,0
50578,445,0,0,66,66,0,1,0,1,0
61666,443,28189,443,1786,172,1614,7,120,3,4
5588,5588,0,0,3354,1792,1562,46,193,23,23
63963,445,0,0,70,70,0,1,0,1,0
29145,8168,0,0,62,62,0,1,0,1,0
49981,53,37329,53,438,180,258,6,30,3,3
28699,53,53419,53,278,86,192,2,30,1,1
37584,80,39013,80,3587,2484,1103,19,135,10,9
49910,445,0,0,66,66,0,1,0,1,0
52558,445,0,0,70,70,0,1,0,1,0
55688,53,29259,53,184,94,90,2,31,1,1
57978,80,62070,80,4402,2878,1524,29,105,15,14
42379,443,33462,443,1622,1137,485,11,26,7,4
63872,445,0,0,70,70,0,1,0,1,0
49305,53,42044,53,177,94,83,2,30,1,1
51945,445,0,0,70,70,0,1,0,1,0
61392,50584,0,0,146,146,0,1,0,1,0
60048,445,0,0,70,70,0,1,0,1,0
6881,6881,0,0,62,62,0,1,0,1,0
49889,445,0,0,66,66,0,1,0,1,0
8297,37965,0,0,62,62,0,1,0,1,0
50122,443,55695,443,6407,1101,5306,18,26,10,8
26566,44847,0,0,66,66,0,1,0,1,0
55733,53,35309,53,170,87,83,2,31,1,1
52827,25174,0,0,62,62,0,1,0,1,0
57585,443,57585,443,2504,1458,1046,21,87,10,11
60011,443,19677,443,8413,3768,4645,25,143,12,13
50498,445,0,0,70,70,0,1,0,1,0
62933,445,0,0,70,70,0,1,0,1,0
57319,53,46855,53,353,94,259,2,30,1,1
41940,443,2811,443,26974,22004,4970,80,216,42,38
38405,80,54534,80,1114,534,580,12,16,7,5
52838,445,0,0,66,66,0,1,0,1,0
13285,29892,0,0,145,145,0,1,0,1,0
36005,22,0,0,60,60,0,1,0,1,0
59271,443,60275,443,26414,4349,22065,41,149,17,24
50377,53,24974,53,753,94,659,2,30,1,1
20864,51221,0,0,62,62,0,1,0,1,0
49269,53,11598,53,254,102,152,2,30,1,1
65224,53,24023,53,994,86,908,2,31,1,1
56901,445,0,0,66,66,0,1,0,1,0
3792,52700,0,0,62,62,0,1,0,1,0
58598,50584,0,0,66,66,0,1,0,1,0
49440,443,48823,443,3721809,103604,3618205,3808,156,1281,2527
49420,443,10802,443,4932,1046,3886,21,173,10,11
36575,443,29496,443,412,140,272,7,25,3,4
32971,443,32971,443,18895,2061,16834,34,17,18,16
59823,443,61551,443,306,180,126,6,29,4,2
44320,443,45352,443,1657,1128,529,15,35,9,6
56612,443,14658,443,4378,1140,3238,14,26,9,5
56365,443,42336,443,4850,2997,1853,20,234,12,8
62904,80,35309,80,1515,481,1034,11,16,6,5
45908,33330,0,0,60,60,0,1,0,1,0
63853,10659,14752,10659,66,66,0,2,8,2,0
64191,53,5419,53,197,94,103,2,30,1,1
53159,58710,30090,58710,698,320,378,10,18,6,4
57406,53,28886,53,761,100,661,2,30,1,1
37578,443,38222,443,499,425,74,4,0,3,1
56512,53,52518,53,889,404,485,10,31,5,5
60500,445,0,0,66,66,0,1,0,1,0
33611,443,49502,443,9490,1158,8332,24,256,13,11
55334,445,0,0,70,70,0,1,0,1,0
53971,80,16324,80,662,448,214,10,15,7,3
54166,25174,0,0,66,66,0,1,0,1,0
39648,443,15824,443,5663,4227,1436,27,47,16,11
42076,443,63627,443,22106,5214,16892,23,128,9,14
58691,445,0,0,66,66,0,1,0,1,0
58638,5900,0,0,62,62,0,1,0,1,0
59943,443,41706,443,2979,914,2065,10,120,5,5
54996,53,30248,53,252,102,150,2,29,1,1
54752,445,0,0,70,70,0,1,0,1,0
54142,20541,0,0,62,62,0,1,0,1,0
55664,53,60480,53,177,94,83,2,29,1,1
30332,48817,0,0,145,145,0,1,0,1,0
443,62732,0,0,199,199,0,1,0,1,0
37320,443,60186,443,70,70,0,1,5,1,0
42417,22114,0,0,62,62,0,1,0,1,0
59853,445,0,0,66,66,0,1,0,1,0
64825,53,52627,53,184,94,90,2,30,1,1
64925,53,10435,53,338,110,228,2,30,1,1
26852,443,37860,443,6701,2064,4637,19,19,9,10
50459,80,33223,80,1328,917,411,10,28,6,4
45257,443,55440,443,36062,4663,31399,87,33,41,46
9377,56205,0,0,66,66,0,1,0,1,0
46864,25174,0,0,146,146,0,1,0,1,0
51696,445,0,0,70,70,0,1,0,1,0
58953,443,9937,443,4051,2587,1464,18,16,9,9
54912,443,54912,443,4401,1494,2907,19,27,11,8
52144,49344,0,0,62,62,0,1,0,1,0
63020,445,0,0,70,70,0,1,0,1,0
57416,66,12942,66,70,70,0,1,4,1,0
43865,443,4892,443,560,280,280,9,26,5,4
56650,443,36450,443,4628,1035,3593,19,25,11,8
50327,80,7970,80,366,180,186,7,47,4,3
53475,3389,0,0,66,66,0,1,0,1,0
64579,37965,0,0,66,66,0,1,0,1,0
49999,53,62191,53,316,91,225,4,46,2,2
64709,53,47288,53,353,118,235,2,30,1,1
65300,53,17594,53,329,88,241,4,50,2,2
60390,56494,54167,56494,70,70,0,1,5,1,0
64085,53,40904,53,195,94,101,2,31,1,1
65318,53,17829,53,184,94,90,2,31,1,1
60568,445,0,0,66,66,0,1,0,1,0
34936,30188,0,0,66,66,0,1,0,1,0
53047,445,0,0,66,66,0,1,0,1,0
3541,22114,0,0,62,62,0,1,0,1,0
52208,80,51352,80,372,246,126,6,28,4,2
50645,53,59508,53,177,94,83,2,30,1,1
30304,26467,0,0,62,62,0,1,0,1,0
53808,56215,4312,56215,70,70,0,1,4,1,0
54749,445,0,0,70,70,0,1,0,1,0
63533,445,0,0,70,70,0,1,0,1,0
64950,53,51754,53,728,102,626,2,30,1,1
55634,53,10243,53,210,110,100,2,30,1,1
60864,5223,16379,5223,194,134,60,2,5,1,1
42030,25,0,0,74,74,0,1,0,1,0
56536,443,5996,443,210110,14803,195307,246,105,103,143
57275,53,57275,53,217,86,131,2,30,1,1
56680,443,53449,443,7889,1900,5989,20,15,11,9
1091,37965,0,0,62,62,0,1,0,1,0
57946,445,0,0,70,70,0,1,0,1,0
55060,445,0,0,70,70,0,1,0,1,0
55646,445,0,0,70,70,0,1,0,1,0
50027,53,20964,53,264,110,154,2,30,1,1
53487,445,0,0,70,70,0,1,0,1,0
54045,445,0,0,70,70,0,1,0,1,0
56739,53,56739,53,825,99,726,2,30,1,1
52137,445,0,0,70,70,0,1,0,1,0
61419,443,21446,443,1664127,116770,1547357,2028,401,736,1292
53848,443,21534,443,7015200,135026,6880174,6063,438,1252,4811
51754,18375,0,0,66,66,0,1,0,1,0
61675,80,46507,80,5108,676,4432,14,15,7,7
53192,445,0,0,66,66,0,1,0,1,0
52086,445,0,0,66,66,0,1,0,1,0
45082,17,0,0,60,60,0,1,0,1,0
57955,44847,0,0,62,62,0,1,0,1,0
57302,53,18711,53,770,102,668,2,31,1,1
63058,443,54083,443,304,86,218,2,30,1,1
64530,445,0,0,70,70,0,1,0,1,0
51708,21278,38128,21278,70,70,0,1,5,1,0
27005,27015,56487,27015,892,126,766,2,30,1,1
42282,443,42282,443,2052,1187,865,21,76,11,10
56433,53,16233,53,204,104,100,2,30,1,1
36476,5228,61709,5228,21282,7311,13971,96,1216,47,49
49365,443,7020,443,442336,371266,71070,1143,762,651,492
60715,443,1663,443,1716,1136,580,15,30,9,6
52932,443,50755,443,3032,1082,1950,9,120,5,4
49523,53,10736,53,728,96,632,2,30,1,1
65325,53,48288,53,216,110,106,2,30,1,1
64772,53,64772,53,241,98,143,2,30,1,1
58751,443,12034,443,10505,6856,3649,29,16,15,14
62189,64147,0,0,62,62,0,1,0,1,0
50359,80,14465,80,1770,961,809,10,15,5,5
59343,80,59343,80,32527,13068,19459,56,15,21,35
54976,15503,0,0,62,62,0,1,0,1,0
63234,445,0,0,70,70,0,1,0,1,0
57207,53,55086,53,195,102,93,2,30,1,1
35441,5222,17710,5222,10854,4776,6078,80,119,41,39
50112,445,0,0,70,70,0,1,0,1,0
55803,445,0,0,70,70,0,1,0,1,0
53791,53,58724,53,204,204,0,3,46,3,0
51959,443,18601,443,20648,4726,15922,40,48,19,21
49684,80,60336,80,13889,4084,9805,27,16,13,14
33610,443,59796,443,9490,1158,8332,24,257,13,11
23091,11119,0,0,148,148,0,1,0,1,0
56656,445,0,0,66,66,0,1,0,1,0
49549,443,14886,443,19491,14463,5028,50,224,26,24
64674,445,0,0,70,70,0,1,0,1,0
50229,80,35977,80,1743,979,764,13,81,7,6
55072,53,58133,53,168,86,82,2,30,1,1
63937,53,8865,53,183,94,89,2,30,1,1
49178,53,26968,53,199,102,97,2,29,1,1
51471,445,0,0,66,66,0,1,0,1,0
63983,445,0,0,70,70,0,1,0,1,0
65511,53,1627,53,212,102,110,2,30,1,1
49632,443,26348,443,3618,961,2657,13,121,6,7
57416,53,52623,53,186,95,91,2,30,1,1
51952,443,19528,443,11367,3820,7547,28,28,16,12
23969,57470,0,0,62,62,0,1,0,1,0
65048,53,24505,53,396,84,312,4,54,2,2
64823,53,51719,53,199,102,97,2,30,1,1
57987,80,45212,80,2803,1625,1178,16,21,9,7
50102,17546,0,0,66,66,0,1,0,1,0
9436,443,44079,443,5693,499,5194,14,15,7,7
49228,443,26216,443,13758,6577,7181,66,918,34,32
51197,445,0,0,70,70,0,1,0,1,0
64986,53,34295,53,183,94,89,2,30,1,1
52501,443,44230,443,163226,10147,153079,233,101,101,132
12737,35440,0,0,62,62,0,1,0,1,0
50811,443,33324,443,2719275,48822,2670453,2459,127,689,1770
52471,443,40608,443,41966,23593,18373,89,154,42,47
58638,5900,0,0,62,62,0,1,0,1,0
55615,53,40819,53,225,110,115,2,30,1,1
41524,443,23023,443,3976,2652,1324,20,312,11,9
63918,445,0,0,66,66,0,1,0,1,0
52083,26607,11051,26607,70,70,0,2,7,2,0
52027,49743,54736,49743,70,70,0,2,7,2,0
80,9918,0,0,60,60,0,1,0,1,0
56385,53,50438,53,249,85,164,4,56,2,2
55808,53,62686,53,174,89,85,2,30,1,1
59921,445,0,0,66,66,0,1,0,1,0
53097,443,17057,443,7013,1718,5295,18,326,9,9
64942,53,4876,53,284,102,182,4,37,2,2
34285,53,45642,53,168,78,90,2,30,1,1
50541,53,14016,53,458,188,270,6,30,3,3
49360,53,44969,53,263,102,161,2,29,1,1
65518,5710,0,0,62,62,0,1,0,1,0
13285,29892,0,0,145,145,0,1,0,1,0
50438,19426,0,0,62,62,0,1,0,1,0
20619,25174,0,0,66,66,0,1,0,1,0
49418,27222,49485,27222,245,78,167,2,30,1,1
59957,443,65089,443,8677,2714,5963,21,114,13,8
61462,443,27750,443,6271,1191,5080,24,94,14,10
59564,57470,0,0,66,66,0,1,0,1,0
56760,53,34251,53,216,102,114,2,30,1,1
60241,445,0,0,70,70,0,1,0,1,0
65367,53,17484,53,271,94,177,2,30,1,1
63397,26467,0,0,66,66,0,1,0,1,0
55113,53,29716,53,196,100,96,2,31,1,1
2705,37,0,0,60,60,0,1,0,1,0
39570,62413,0,0,146,146,0,1,0,1,0
62012,445,0,0,70,70,0,1,0,1,0
35637,443,59473,443,5611,1559,4052,22,648,13,9
62061,53,49325,53,181,78,103,2,30,1,1
63843,445,0,0,70,70,0,1,0,1,0
57470,22070,58715,22070,559,198,361,5,1200,4,1
64406,50584,0,0,66,66,0,1,0,1,0
33524,10387,0,0,159,159,0,1,0,1,0
30913,33876,0,0,145,145,0,1,0,1,0
53889,445,0,0,70,70,0,1,0,1,0
57474,445,0,0,70,70,0,1,0,1,0
49345,80,49345,80,450,246,204,8,142,5,3
61711,35440,0,0,62,62,0,1,0,1,0
51655,26467,0,0,62,62,0,1,0,1,0
56872,53,25005,53,443,182,261,6,29,3,3
61218,22114,0,0,66,66,0,1,0,1,0
56728,445,0,0,70,70,0,1,0,1,0
50753,445,0,0,66,66,0,1,0,1,0
60369,443,60379,443,7939,955,6984,22,107,11,11
63179,445,0,0,70,70,0,1,0,1,0
62084,445,0,0,70,70,0,1,0,1,0
49633,53,37557,53,210,102,108,2,30,1,1
56679,443,4543,443,7941,1952,5989,20,15,11,9
55874,64147,0,0,66,66,0,1,0,1,0
63433,445,0,0,70,70,0,1,0,1,0
49548,53,36556,53,198,94,104,2,29,1,1
49640,53,5967,53,402,118,284,2,30,1,1
55373,445,0,0,70,70,0,1,0,1,0
52695,26467,0,0,66,66,0,1,0,1,0
26900,27017,43852,27017,422,164,258,6,29,3,3
50265,27034,40304,27034,480,149,331,2,1200,1,1
25061,53,25061,53,214,82,132,2,32,1,1
56427,53,59591,53,166,86,80,2,30,1,1
52789,445,0,0,66,66,0,1,0,1,0
1319,443,12846,443,448,256,192,8,25,5,3
53245,443,26528,443,7705,2005,5700,26,120,13,13
56119,53,4548,53,199,102,97,2,30,1,1
45060,37965,0,0,62,62,0,1,0,1,0
57311,53,54078,53,211,102,109,2,30,1,1
52105,1024,36023,1024,70,70,0,2,7,2,0
52107,53,0,0,210,77,133,2,29,1,1
56542,53,15813,53,183,94,89,2,30,1,1
63704,445,0,0,70,70,0,1,0,1,0
52062,60388,22555,60388,70,70,0,1,5,1,0
52849,445,0,0,70,70,0,1,0,1,0
43675,80,34710,80,1676620,41953,1634667,1725,25,636,1089
58555,445,0,0,70,70,0,1,0,1,0
62358,445,0,0,66,66,0,1,0,1,0
64249,53,23999,53,181,94,87,2,33,1,1
49438,443,56148,443,180,60,120,4,15,2,2
56186,53,56186,53,233,98,135,2,30,1,1
60096,445,0,0,70,70,0,1,0,1,0
49464,53,1533,53,213,102,111,2,30,1,1
56853,53,24934,53,167,86,81,2,29,1,1
49532,443,49532,443,20488,16649,3839,30,24,18,12
49418,27015,26832,27015,248,78,170,2,30,1,1
55211,445,0,0,66,66,0,1,0,1,0
57594,80,6266,80,486,280,206,8,25,5,3
65359,53,19133,53,193,102,91,2,31,1,1
44847,6881,59803,6881,484,150,334,2,1200,1,1
57187,53,15982,53,782,105,677,2,30,1,1
65291,53,61483,53,190,97,93,2,31,1,1
63963,50584,0,0,66,66,0,1,0,1,0
12527,50584,0,0,62,62,0,1,0,1,0
41153,53,8565,53,168,78,90,2,30,1,1
10092,443,29539,443,130,70,60,3,5,2,1
49658,443,46695,443,11880,2839,9041,30,48,16,14
11295,40033,3453,40033,213,89,124,4,32,2,2
31974,51505,0,0,66,66,0,1,0,1,0
60018,443,59209,443,117023,8825,108198,138,143,49,89
56226,53,8376,53,284,96,188,4,31,2,2
49506,53,23058,53,200,102,98,2,30,1,1
49218,5222,44351,5222,85080,31769,53311,661,1172,305,356
54217,445,0,0,66,66,0,1,0,1,0
58638,5900,0,0,62,62,0,1,0,1,0
57235,53,3428,53,212,102,110,2,30,1,1
57434,443,22130,443,9237,2447,6790,30,16,14,16
17750,14132,3203,14132,150,150,0,1,1200,1,0
56169,53,27417,53,210,110,100,2,29,1,1
39009,443,34628,443,12197,2338,9859,34,122,14,20
26531,37965,0,0,62,62,0,1,0,1,0
46031,443,52828,443,12395,2182,10213,21,122,10,11
55859,53,59697,53,210,110,100,2,30,1,1
56753,44847,0,0,62,62,0,1,0,1,0
0,0,0,0,244,244,0,2,0,2,0
52123,1433,0,0,60,60,0,1,0,1,0
51413,54351,0,0,136,136,0,1,0,1,0
65225,53,58694,53,199,102,97,2,30,1,1
54995,443,62942,443,23418,2454,20964,56,197,26,30
42989,443,61280,443,9878,1936,7942,36,121,18,18
16387,49252,0,0,60,60,0,1,0,1,0
54458,443,1235,443,3885,2355,1530,26,270,13,13
51954,80,41489,80,18285,8756,9529,29,27,15,14
59356,445,0,0,70,70,0,1,0,1,0
63691,445,0,0,70,70,0,1,0,1,0
36277,443,45497,443,14212,8194,6018,38,104,21,17
64731,53,27701,53,403,142,261,2,30,1,1
19944,22114,0,0,62,62,0,1,0,1,0
55735,53,20718,53,184,94,90,2,30,1,1
36936,53,30039,53,78,78,0,1,30,1,0
39895,26467,0,0,62,62,0,1,0,1,0
61808,18375,0,0,66,66,0,1,0,1,0
60381,80,60381,80,448865,6437,442428,380,151,67,313
65189,27016,20619,27016,249,78,171,2,29,1,1
54235,443,28529,443,4665,2167,2498,23,16,12,11
50424,53,47336,53,195,102,93,2,30,1,1
51354,445,0,0,70,70,0,1,0,1,0
56198,53,50578,53,184,102,82,2,30,1,1
53708,23280,6417,23280,1903,968,935,16,16,9,7
18063,53,18063,53,219,87,132,2,30,1,1
51942,443,54861,443,2646,1322,1324,28,36,15,13
55296,23718,0,0,66,66,0,1,0,1,0
80,65095,0,0,66,66,0,1,0,1,0
52038,50584,0,0,62,62,0,1,0,1,0
53408,50243,0,0,145,145,0,1,0,1,0
26900,27017,35355,27017,422,164,258,6,30,3,3
43024,53,45972,53,198,93,105,2,30,1,1
11677,56205,0,0,62,62,0,1,0,1,0
53852,443,26865,443,499,425,74,4,0,3,1
39839,22114,0,0,146,146,0,1,0,1,0
49518,53,34801,53,213,102,111,2,30,1,1
51780,21130,19007,21130,66,66,0,1,5,1,0
52062,80,7748,80,366,240,126,7,26,5,2
33856,443,15413,443,8171028,105740,8065288,6637,149,745,5892
56755,445,0,0,70,70,0,1,0,1,0
43333,50584,0,0,146,146,0,1,0,1,0
59771,445,0,0,66,66,0,1,0,1,0
63988,53,39055,53,190,97,93,2,30,1,1
61569,445,0,0,70,70,0,1,0,1,0
52159,16297,42997,16297,70,70,0,1,5,1,0
65028,445,0,0,70,70,0,1,0,1,0
8883,443,24361,443,9742,2044,7698,30,391,12,18
54976,15503,0,0,66,66,0,1,0,1,0
58273,445,0,0,70,70,0,1,0,1,0
64545,445,0,0,70,70,0,1,0,1,0
49418,27056,31810,27056,269,78,191,2,30,1,1
52490,443,51639,443,23518,8884,14634,32,15,15,17
57706,445,0,0,70,70,0,1,0,1,0
56654,53,59245,53,202,103,99,2,31,1,1
56812,443,43977,443,11568,9158,2410,42,80,23,19
64772,445,0,0,70,70,0,1,0,1,0
61474,443,20361,443,114674,4457,110217,127,48,46,81
50348,80,25254,80,4929,2773,2156,17,42,9,8
63896,80,57609,80,314,192,122,6,15,4,2
49795,53,1877,53,211,102,109,2,30,1,1
61717,445,0,0,70,70,0,1,0,1,0
65330,53,32414,53,733,94,639,2,30,1,1
58302,443,57426,443,4568,2059,2509,17,33,9,8
28973,30188,0,0,66,66,0,1,0,1,0
47803,64147,0,0,145,145,0,1,0,1,0
52321,26467,0,0,62,62,0,1,0,1,0
18291,37807,0,0,146,146,0,1,0,1,0
56004,53,27325,53,177,94,83,2,29,1,1
57701,445,0,0,70,70,0,1,0,1,0
56472,53,22766,53,177,94,83,2,30,1,1
26458,80,26458,80,490,264,226,8,32,5,3
50255,53,55681,53,199,102,97,2,29,1,1
443,59890,0,0,60,60,0,1,0,1,0
56388,22114,0,0,66,66,0,1,0,1,0
64017,53,51575,53,202,103,99,2,30,1,1
57558,443,4202,443,42986,7555,35431,69,125,29,40
55477,80,28863,80,498,280,218,8,26,5,3
63812,445,0,0,70,70,0,1,0,1,0
55571,445,0,0,70,70,0,1,0,1,0
55603,443,55603,443,4684,1777,2907,19,12,11,8
60877,445,0,0,70,70,0,1,0,1,0
45964,2225,0,0,60,60,0,1,0,1,0
50280,57470,0,0,78,78,0,1,0,1,0
61128,445,0,0,70,70,0,1,0,1,0
56552,445,0,0,70,70,0,1,0,1,0
55582,53,48223,53,344,107,237,4,54,2,2
57936,443,57936,443,18738,1904,16834,33,17,17,16
50095,50584,0,0,66,66,0,1,0,1,0
55055,445,0,0,70,70,0,1,0,1,0
28003,443,64020,443,5515,1388,4127,18,15,9,9
62812,445,0,0,70,70,0,1,0,1,0
64702,53,11324,53,760,97,663,2,31,1,1
51940,53,28110,53,199,94,105,2,30,1,1
32707,11392,0,0,62,62,0,1,0,1,0
49505,445,0,0,70,70,0,1,0,1,0
26900,27017,34490,27017,422,164,258,6,30,3,3
63992,53,33581,53,198,101,97,2,31,1,1
51159,445,0,0,70,70,0,1,0,1,0
49173,27402,64212,27402,70,70,0,1,5,1,0
56330,53,9857,53,271,95,176,4,48,2,2
65176,53,48862,53,193,102,91,2,31,1,1
56404,445,0,0,66,66,0,1,0,1,0
56793,443,4192,443,8022,2002,6020,20,16,11,9
64106,53,59908,53,190,97,93,2,31,1,1
51492,80,15284,80,1517,481,1036,11,15,6,5
80,9918,0,0,60,60,0,1,0,1,0
65224,53,48832,53,758,93,665,2,30,1,1
40204,40038,53758,40038,585,86,499,2,30,1,1
56168,445,0,0,70,70,0,1,0,1,0
49790,53,24988,53,190,97,93,2,30,1,1
50933,443,10395,443,10546,2453,8093,28,15,16,12
56927,53,19352,53,182,93,89,2,31,1,1
49937,445,0,0,70,70,0,1,0,1,0
50632,443,47511,443,4158,1021,3137,15,26,8,7
19623,25174,0,0,62,62,0,1,0,1,0
51903,35904,40844,35904,70,70,0,1,5,1,0
30960,45751,20805,45751,66,66,0,1,3600,1,0
15235,36237,0,0,62,62,0,1,0,1,0
34440,53,34440,53,235,90,145,2,32,1,1
49451,445,0,0,70,70,0,1,0,1,0
52024,25174,0,0,66,66,0,1,0,1,0
64991,53,47067,53,625,192,433,6,46,3,3
48706,23393,0,0,60,60,0,1,0,1,0
64103,38976,24644,38976,66,66,0,2,8,2,0
51724,25807,54569,25807,70,70,0,2,8,2,0
63301,445,0,0,70,70,0,1,0,1,0
50667,443,38450,443,8536,2068,6468,36,18,16,20
62388,445,0,0,66,66,0,1,0,1,0
53343,445,0,0,70,70,0,1,0,1,0
49830,443,7649,443,6131,1960,4171,18,15,10,8
64903,445,0,0,70,70,0,1,0,1,0
51810,445,0,0,70,70,0,1,0,1,0
62548,445,0,0,70,70,0,1,0,1,0
56363,443,4827,443,4864,3011,1853,20,234,12,8
24351,57470,0,0,62,62,0,1,0,1,0
21944,53,21944,53,217,82,135,2,32,1,1
36022,443,7743,443,7257,1619,5638,22,275,11,11
57131,26296,0,0,145,145,0,1,0,1,0
27147,22114,0,0,62,62,0,1,0,1,0
51160,445,0,0,70,70,0,1,0,1,0
57185,53,50357,53,784,94,690,2,30,1,1
53901,443,43794,443,499,425,74,4,0,3,1
52341,80,52341,80,1928,1339,589,12,48,6,6
54982,53,63300,53,282,96,186,4,48,2,2
50338,443,61638,443,6441,1651,4790,22,53,12,10
49847,53,33024,53,448,184,264,6,29,3,3
37965,16153,40075,16153,1320,1320,0,21,1682,21,0
37264,443,41734,443,130,70,60,3,5,2,1
55640,53,37187,53,797,208,589,6,67,3,3
50064,445,0,0,70,70,0,1,0,1,0
53199,30188,0,0,66,66,0,1,0,1,0
49431,53,38249,53,767,102,665,2,30,1,1
53221,443,43184,443,57706,2486,55220,67,65,23,44
44673,80,44673,80,1916,1467,449,10,20,6,4
46518,44847,0,0,146,146,0,1,0,1,0
3170,53567,0,0,66,66,0,1,0,1,0
49650,53,24810,53,216,110,106,2,29,1,1
53117,445,0,0,70,70,0,1,0,1,0
5530,80,5530,80,514,246,268,9,91,5,4
50080,445,0,0,66,66,0,1,0,1,0
38664,443,19990,443,8195,1780,6415,23,60,12,11
30960,45673,1133,45673,462,462,0,8,3633,8,0
22948,26467,0,0,62,62,0,1,0,1,0
64963,445,0,0,70,70,0,1,0,1,0
60025,445,0,0,70,70,0,1,0,1,0
37587,443,9282,443,6912,1841,5071,33,27,17,16
53958,80,11138,80,130,70,60,2,15,1,1
65236,53,60243,53,247,118,129,2,30,1,1
38358,22300,0,0,60,60,0,1,0,1,0
43350,58414,0,0,66,66,0,1,0,1,0
17750,27517,53975,27517,491,150,341,2,1200,1,1
53623,445,0,0,66,66,0,1,0,1,0
49680,80,4197,80,1548,847,701,10,16,5,5
40301,8696,0,0,60,60,0,1,0,1,0
38911,443,33015,443,13187,2075,11112,35,420,11,24
49499,443,13640,443,87970,5355,82615,141,483,55,86
52625,25174,0,0,62,62,0,1,0,1,0
21419,23,0,0,60,60,0,1,0,1,0
53640,25174,0,0,62,62,0,1,0,1,0
53774,51505,0,0,66,66,0,1,0,1,0
50020,53,1594,53,210,102,108,2,30,1,1
57156,445,0,0,66,66,0,1,0,1,0
58850,53,58850,53,231,90,141,2,29,1,1
64707,445,0,0,70,70,0,1,0,1,0
53777,443,29327,443,495,421,74,4,0,3,1
56447,53,39784,53,403,110,293,2,30,1,1
55862,62413,0,0,62,62,0,1,0,1,0
59413,51505,0,0,66,66,0,1,0,1,0
53229,443,57933,443,91414,11700,79714,174,59,65,109
55153,443,47094,443,5897,1982,3915,20,18,11,9
55559,53,16251,53,182,94,88,2,30,1,1
56955,53,64522,53,183,94,89,2,30,1,1
50584,53,19282,53,738,86,652,2,30,1,1
56143,53,31546,53,748,106,642,2,31,1,1
40418,25174,0,0,66,66,0,1,0,1,0
45510,443,22832,443,130,70,60,2,15,1,1
27005,27015,12555,27015,887,126,761,2,30,1,1
58638,5900,0,0,62,62,0,1,0,1,0
50466,53,28614,53,199,102,97,2,30,1,1
50532,80,48066,80,4561,2110,2451,15,26,9,6
54830,443,23517,443,4478,1133,3345,13,26,8,5
22983,443,22983,443,205941,20753,185188,264,30,129,135
60319,80,61391,80,194,128,66,4,25,3,1
57073,53,22592,53,197,102,95,2,33,1,1
51791,445,0,0,70,70,0,1,0,1,0
54846,53,32938,53,168,78,90,2,30,1,1
51442,443,50943,443,15321,3760,11561,56,170,23,33
51796,48779,55326,48779,70,70,0,2,8,2,0
40239,22114,0,0,146,146,0,1,0,1,0
56654,53,54903,53,102,102,0,2,31,2,0
49454,53,56383,53,762,97,665,2,31,1,1
17855,53,17855,53,240,98,142,2,30,1,1
55561,53,57871,53,313,102,211,2,30,1,1
54470,80,58006,80,16896,1514,15382,30,255,16,14
53637,443,7341,443,8473,1099,7374,20,119,9,11
58076,21247,0,0,62,62,0,1,0,1,0
56202,15503,0,0,146,146,0,1,0,1,0
62345,445,0,0,66,66,0,1,0,1,0
49951,80,49951,80,24361943,451235,23910708,22804,63,6533,16271
55806,53,43969,53,200,102,98,2,32,1,1
49964,53,64934,53,749,94,655,2,30,1,1
57643,445,0,0,70,70,0,1,0,1,0
53521,443,40751,443,130,70,60,2,14,1,1
42532,22114,0,0,62,62,0,1,0,1,0
49726,445,0,0,70,70,0,1,0,1,0
51766,445,0,0,70,70,0,1,0,1,0
59046,443,4447,443,8279,2876,5403,22,155,9,13
41674,5900,0,0,60,60,0,1,0,1,0
62965,445,0,0,70,70,0,1,0,1,0
49742,53,51185,53,216,110,106,2,30,1,1
33418,443,42698,443,4764,1876,2888,22,81,10,12
65236,53,5620,53,758,102,656,2,30,1,1
60334,7080,60334,7080,2960,432,2528,11,15,6,5
59225,57587,0,0,66,66,0,1,0,1,0
49706,80,39061,80,118813,4128,114685,122,108,38,84
57339,53,43284,53,184,80,104,2,30,1,1
62388,39004,0,0,145,145,0,1,0,1,0
51396,56205,0,0,66,66,0,1,0,1,0
49331,443,35944,443,78663,4968,73695,85,47,24,61
56014,445,0,0,70,70,0,1,0,1,0
49674,445,0,0,70,70,0,1,0,1,0
50139,5228,61271,5228,7727,2172,5555,44,104,23,21
54436,445,0,0,70,70,0,1,0,1,0
1227,56205,0,0,66,66,0,1,0,1,0
43286,80,30144,80,1638,1324,314,10,15,5,5
64006,53,16897,53,394,96,298,4,47,2,2
52518,35440,0,0,66,66,0,1,0,1,0
55766,443,53751,443,1864,250,1614,8,120,4,4
19473,51413,49212,51413,459,149,310,2,1200,1,1
46948,443,43691,443,6374,2446,3928,26,217,13,13
59969,445,0,0,70,70,0,1,0,1,0
48266,80,46749,80,130,70,60,2,15,1,1
56131,37807,0,0,66,66,0,1,0,1,0
50584,6889,59579,6889,161,161,0,2,1200,2,0
54968,53,59501,53,199,102,97,2,30,1,1
65216,53,28628,53,218,94,124,2,30,1,1
3478,61463,0,0,164,164,0,1,0,1,0
49418,27016,31344,27016,250,78,172,2,31,1,1
40710,5228,9746,5228,4065,2585,1480,28,40,14,14
58610,445,0,0,66,66,0,1,0,1,0
52533,445,0,0,66,66,0,1,0,1,0
30697,57866,0,0,62,62,0,1,0,1,0
39473,443,53063,443,9590,3811,5779,20,122,10,10
52148,445,0,0,66,66,0,1,0,1,0
443,44683,0,0,83,83,0,1,0,1,0
7310,44847,0,0,62,62,0,1,0,1,0
443,49988,0,0,82,82,0,1,0,1,0
53503,445,0,0,70,70,0,1,0,1,0
1092,57470,0,0,145,145,0,1,0,1,0
515,10214,0,0,66,66,0,1,0,1,0
65206,53,13449,53,330,118,212,2,30,1,1
49418,27118,47467,27118,78,78,0,1,30,1,0
39328,80,62636,80,234,234,0,4,12,4,0
64449,30188,0,0,66,66,0,1,0,1,0
56337,443,18375,443,9683,2173,7510,35,26,17,18
53270,443,54512,443,12757,4360,8397,41,17,23,18
65212,53,30386,53,196,102,94,2,30,1,1
60092,51505,0,0,62,62,0,1,0,1,0
54351,445,0,0,70,70,0,1,0,1,0
58844,443,8325,443,5167,700,4467,16,15,7,9
60133,1,0,0,66,66,0,1,0,1,0
56307,53,64603,53,168,78,90,2,30,1,1
50861,3389,50861,3389,4241,2521,1720,18,32,10,8
53160,39001,22070,39001,70,70,0,2,8,2,0
52327,445,0,0,70,70,0,1,0,1,0
64076,53,18119,53,353,118,235,2,30,1,1
45339,443,35795,443,2312,1382,930,19,34,11,8
55352,445,0,0,66,66,0,1,0,1,0
37455,50584,0,0,66,66,0,1,0,1,0
32967,80,37431,80,21387,1482,19905,38,18,19,19
49589,53,21247,53,198,94,104,2,30,1,1
60303,443,13935,443,3928,2467,1461,27,144,14,13
49818,53,37745,53,86,86,0,1,30,1,0
45941,23386,0,0,60,60,0,1,0,1,0
58872,443,3820,443,1178,820,358,9,15,6,3
58370,443,50234,443,6277528,124223,6153305,5970,160,1890,4080
49834,443,28335,443,9890,4516,5374,26,124,14,12
2062,35440,0,0,66,66,0,1,0,1,0
52265,32078,35097,32078,70,70,0,2,7,2,0
6712,5632,0,0,60,60,0,1,0,1,0
52724,445,0,0,66,66,0,1,0,1,0
55945,53,36008,53,760,97,663,2,30,1,1
54227,443,59982,443,499,425,74,4,0,3,1
51029,445,0,0,70,70,0,1,0,1,0
27005,27017,42100,27017,891,126,765,2,30,1,1
64637,53,20905,53,810,108,702,2,30,1,1
50700,80,35384,80,142,142,0,1,4,1,0
55159,53,25315,53,199,102,97,2,29,1,1
40865,8100,52976,8100,78,78,0,1,5,1,0
42107,443,39392,443,13704,2379,11325,47,279,22,25
50561,80,19741,80,318,192,126,6,26,4,2
50658,80,54358,80,5018,4314,704,11,30,6,5
58638,5900,0,0,62,62,0,1,0,1,0
56356,53,61835,53,184,102,82,2,30,1,1
60312,80,47441,80,2390,532,1858,11,75,6,5
65377,443,4212,443,4864,2496,2368,33,121,17,16
57911,445,0,0,70,70,0,1,0,1,0
57367,443,24702,443,7498,2799,4699,24,17,13,11
49418,27015,33694,27015,246,78,168,2,31,1,1
27005,27015,48788,27015,913,126,787,2,30,1,1
56993,80,53078,80,214,140,74,4,35,3,1
51844,443,37014,443,6752,1387,5365,21,115,10,11
52876,445,0,0,70,70,0,1,0,1,0
26502,80,26502,80,184480,11115,173365,239,30,116,123
50666,80,35544,80,2937,1241,1696,12,22,7,5
51591,80,40282,80,12683,8567,4116,53,271,33,20
63728,11785,52016,11785,66,66,0,2,8,2,0
21173,37965,0,0,62,62,0,1,0,1,0
59839,443,29303,443,93467,4007,89460,107,22,33,74
50276,445,0,0,66,66,0,1,0,1,0
2705,37,0,0,60,60,0,1,0,1,0
57673,53,25100,53,273,94,179,2,30,1,1
51807,443,44757,443,3561,1098,2463,10,121,5,5
9605,57470,0,0,62,62,0,1,0,1,0
0,0,0,0,156,156,0,2,0,2,0
54987,53,61181,53,215,102,113,2,30,1,1
57441,53,16567,53,177,94,83,2,29,1,1
19502,53,19502,53,198,89,109,2,31,1,1
39456,443,56286,443,6944,1650,5294,24,40,14,10
39932,443,25651,443,8309,4385,3924,26,121,12,14
4529,56205,0,0,62,62,0,1,0,1,0
1114,37965,0,0,62,62,0,1,0,1,0
61442,443,19223,443,3403,1891,1512,24,42,13,11
55950,53,65022,53,752,93,659,2,31,1,1
51480,445,0,0,70,70,0,1,0,1,0
65262,80,27207,80,8814,4800,4014,52,629,27,25
59487,445,0,0,66,66,0,1,0,1,0
56041,53,17868,53,179,94,85,2,31,1,1
55167,48817,0,0,66,66,0,1,0,1,0
53547,445,0,0,66,66,0,1,0,1,0
56313,53,7170,53,198,102,96,2,29,1,1
42555,443,40081,443,14262,5874,8388,31,138,15,16
27005,27015,53679,27015,894,126,768,2,30,1,1
22683,39210,0,0,60,60,0,1,0,1,0
60894,443,14726,443,3507,900,2607,13,135,6,7
60891,443,53303,443,204,70,134,4,25,2,2
65011,53,28977,53,183,94,89,2,31,1,1
16370,56205,0,0,62,62,0,1,0,1,0
50552,53,61704,53,757,102,655,2,30,1,1
64687,53,9775,53,183,94,89,2,29,1,1
64693,26467,0,0,62,62,0,1,0,1,0
53373,53,58629,53,242,78,164,2,29,1,1
63989,445,0,0,70,70,0,1,0,1,0
51976,443,42576,443,2466,1497,969,21,46,12,9
65366,53,11375,53,199,102,97,2,30,1,1
61518,22,61518,22,7306,2583,4723,36,25,19,17
49807,53,0,0,218,77,141,2,30,1,1
56474,18375,0,0,62,62,0,1,0,1,0
65064,53,64961,53,197,94,103,2,30,1,1
49418,27200,10128,27200,78,78,0,1,30,1,0
59725,445,0,0,66,66,0,1,0,1,0
62386,445,0,0,70,70,0,1,0,1,0
35649,53,35649,53,220,90,130,2,29,1,1
443,20087,0,0,83,83,0,1,0,1,0
56837,445,0,0,70,70,0,1,0,1,0
55513,53,52238,53,184,94,90,2,29,1,1
52933,445,0,0,66,66,0,1,0,1,0
50592,445,0,0,66,66,0,1,0,1,0
63050,57470,0,0,74,74,0,1,0,1,0
2681,48817,0,0,146,146,0,1,0,1,0
65400,36237,0,0,66,66,0,1,0,1,0
64900,53,46043,53,197,102,95,2,30,1,1
50834,64147,0,0,62,62,0,1,0,1,0
58080,443,57943,443,646,358,288,10,133,6,4
36255,53,36255,53,197,90,107,2,30,1,1
51213,443,22292,443,6333,2018,4315,25,17,15,10
54530,443,34587,443,6202,3033,3169,28,167,13,15
52010,80,42870,80,29838,2481,27357,56,31,24,32
56616,443,54486,443,8033,2013,6020,20,15,11,9
62649,445,0,0,70,70,0,1,0,1,0
49160,50321,21626,50321,150,150,0,2,1200,2,0
59732,27036,24754,27036,1218,924,294,6,30,3,3
64798,53,14494,53,178,94,84,2,30,1,1
16654,50265,0,0,62,62,0,1,0,1,0
49714,80,42166,80,2096,1011,1085,11,130,6,5
52227,445,0,0,70,70,0,1,0,1,0
62830,445,0,0,66,66,0,1,0,1,0
54305,35440,0,0,62,62,0,1,0,1,0
62579,57866,0,0,66,66,0,1,0,1,0
53772,443,49684,443,499,425,74,4,0,3,1
21998,51221,0,0,62,62,0,1,0,1,0
43969,7000,43969,7000,3370,1595,1775,16,15,9,7
58638,5900,0,0,62,62,0,1,0,1,0
51689,4765,24946,4765,66,66,0,1,5,1,0
52757,445,0,0,66,66,0,1,0,1,0
51446,17500,0,0,100,100,0,1,0,1,0
55355,445,0,0,70,70,0,1,0,1,0
58638,5900,0,0,62,62,0,1,0,1,0
44795,443,55624,443,9608,1958,7650,21,15,11,10
49211,443,58097,443,9739,3414,6325,59,928,30,29
30960,45762,15257,45762,330,330,0,6,3609,6,0
57288,53,46993,53,177,94,83,2,30,1,1
63186,445,0,0,66,66,0,1,0,1,0
54598,37965,0,0,66,66,0,1,0,1,0
35558,15503,0,0,66,66,0,1,0,1,0
65200,53,35834,53,290,102,188,2,30,1,1
55496,80,55496,80,1099,578,521,10,15,6,4
49186,53,49186,53,257,101,156,2,32,1,1
14489,25174,0,0,62,62,0,1,0,1,0
62533,445,0,0,70,70,0,1,0,1,0
63323,54369,0,0,78,78,0,1,0,1,0
64041,445,0,0,70,70,0,1,0,1,0
63867,64147,0,0,62,62,0,1,0,1,0
49174,53,58915,53,198,101,97,2,30,1,1
54216,64147,0,0,66,66,0,1,0,1,0
16387,23177,0,0,60,60,0,1,0,1,0
55040,443,46427,443,62,62,0,1,4,1,0
61418,80,59402,80,31954,2972,28982,71,138,36,35
57470,33159,38691,33159,594,594,0,10,1199,10,0
45414,443,2299,443,2215,1412,803,19,38,10,9
59891,445,0,0,70,70,0,1,0,1,0
49924,80,4925,80,1126,609,517,11,15,6,5
64798,53,6106,53,177,94,83,2,29,1,1
53856,443,18832,443,495,421,74,4,0,3,1
57293,443,65420,443,7057,2815,4242,37,18,21,16
64346,51505,0,0,66,66,0,1,0,1,0
60801,40010,50650,40010,316,136,180,6,6,3,3
8180,53,8180,53,220,90,130,2,30,1,1
61701,15503,0,0,66,66,0,1,0,1,0
0,0,0,0,244,244,0,2,0,2,0
35657,48637,0,0,62,62,0,1,0,1,0
64614,53,56180,53,193,102,91,2,30,1,1
49276,53,39804,53,199,102,97,2,29,1,1
50982,445,0,0,66,66,0,1,0,1,0
0,0,0,0,185,185,0,1,0,1,0
60039,53,37317,53,312,82,230,2,31,1,1
49661,443,46909,443,10553,2117,8436,24,46,12,12
52655,445,0,0,70,70,0,1,0,1,0
57335,53,58927,53,177,94,83,2,30,1,1
18331,53,15455,53,376,94,282,2,30,1,1
64242,53,3579,53,180,94,86,2,30,1,1
52880,443,45002,443,1695880,25777,1670103,1423,118,264,1159
63419,445,0,0,70,70,0,1,0,1,0
59592,37965,0,0,62,62,0,1,0,1,0
58888,443,9606,443,5166,700,4466,16,14,7,9
49864,443,13446,443,5930,910,5020,18,56,9,9
53166,53,17813,53,168,78,90,2,30,1,1
51855,23268,62200,23268,70,70,0,2,7,2,0
57396,53,31064,53,183,94,89,2,30,1,1
50178,53,59652,53,178,94,84,2,29,1,1
55713,53,11593,53,308,94,214,2,30,1,1
57343,443,46945,443,1607664,53945,1553719,1792,39,700,1092
65482,53,43448,53,179,94,85,2,30,1,1
45343,443,52570,443,2312,1382,930,19,26,11,8
52951,443,13326,443,628801,19603,609198,708,114,227,481
57470,39541,8082,39541,792,792,0,13,1200,13,0
55688,33958,16437,33958,70,70,0,1,5,1,0
49197,53,3341,53,249,94,155,2,30,1,1
27005,27015,49049,27015,1610,126,1484,4,30,2,2
49001,40108,0,0,161,161,0,1,0,1,0
64890,53,55634,53,210,110,100,2,29,1,1
53471,8118,42759,8118,1745,1091,654,10,31,5,5
36731,80,36731,80,514,246,268,9,75,5,4
53053,64147,0,0,62,62,0,1,0,1,0
6927,52752,0,0,100,100,0,1,0,1,0
55611,445,0,0,70,70,0,1,0,1,0
52230,50265,0,0,66,66,0,1,0,1,0
51862,27758,32851,27758,70,70,0,2,7,2,0
55921,53,64539,53,177,94,83,2,29,1,1
55735,53,9793,53,199,102,97,2,30,1,1
57452,57470,0,0,62,62,0,1,0,1,0
48817,36292,48817,36292,519,158,361,2,1200,1,1
43131,53,0,0,82,82,0,1,30,1,0
26439,37965,0,0,66,66,0,1,0,1,0
58744,1433,0,0,60,60,0,1,0,1,0
1431,30041,0,0,62,62,0,1,0,1,0
64845,53,4147,53,289,110,179,2,30,1,1
55400,445,0,0,66,66,0,1,0,1,0
58498,445,0,0,66,66,0,1,0,1,0
27005,27016,54195,27016,876,126,750,2,30,1,1
64787,53,13133,53,299,101,198,4,34,2,2
1026,30188,0,0,62,62,0,1,0,1,0
55113,53,62810,53,198,102,96,2,33,1,1
58956,445,0,0,66,66,0,1,0,1,0
51045,445,0,0,66,66,0,1,0,1,0
53642,39344,30760,39344,612,306,306,10,15,5,5
56345,53,18764,53,199,94,105,2,30,1,1
57891,80,37829,80,6518,1210,5308,15,24,8,7
27005,32038,32589,32038,868,126,742,2,31,1,1
11562,30188,0,0,62,62,0,1,0,1,0
56594,53,5143,53,173,94,79,2,30,1,1
45682,1,0,0,62,62,0,1,0,1,0
80,37649,0,0,60,60,0,1,0,1,0
19875,30170,0,0,145,145,0,1,0,1,0
59018,445,0,0,70,70,0,1,0,1,0
50556,80,38454,80,378,192,186,7,26,4,3
63711,445,0,0,66,66,0,1,0,1,0
55810,53,5823,53,183,94,89,2,31,1,1
56973,53,45728,53,193,102,91,2,30,1,1
51318,443,40980,443,11191,4657,6534,32,129,14,18
49480,53,12824,53,184,94,90,2,30,1,1
56230,5228,8322,5228,2564,1546,1018,18,3600,9,9
56703,53,34394,53,199,102,97,2,31,1,1
13938,64147,0,0,145,145,0,1,0,1,0
33340,443,55389,443,3598,1118,2480,14,120,7,7
60842,445,0,0,66,66,0,1,0,1,0
63581,445,0,0,66,66,0,1,0,1,0
63245,26296,0,0,159,159,0,1,0,1,0
64314,53,48605,53,264,110,154,2,30,1,1
34112,44847,0,0,66,66,0,1,0,1,0
11464,37965,0,0,62,62,0,1,0,1,0
65359,53,29324,53,186,95,91,2,30,1,1
57249,445,0,0,70,70,0,1,0,1,0
49726,443,20489,443,5393,1263,4130,21,18,11,10
49794,53,12589,53,197,102,95,2,30,1,1
52240,52893,2825,52893,66,66,0,1,5,1,0
56704,445,0,0,70,70,0,1,0,1,0
57044,53,19964,53,194,99,95,2,31,1,1
49686,53,55592,53,183,94,89,2,30,1,1
38693,443,10334,443,90177,3481,86696,96,15,31,65
43537,2323,0,0,60,60,0,1,0,1,0
49214,53,64649,53,227,102,125,2,30,1,1
65239,53,65239,53,231,90,141,2,30,1,1
57152,53,57152,53,241,98,143,2,30,1,1
52241,51717,19106,51717,70,70,0,1,4,1,0
51954,57470,0,0,66,66,0,1,0,1,0
38633,51221,0,0,62,62,0,1,0,1,0
56830,17793,18491,17793,564,318,246,9,15,5,4
57338,443,27463,443,8126,1887,6239,32,732,17,15
37611,443,45731,443,11038,3875,7163,33,16,18,15
8282,40200,5762,40200,133,64,69,3,30,2,1
64980,445,0,0,70,70,0,1,0,1,0
60411,80,48309,80,1589,941,648,11,121,6,5
52489,443,60427,443,32975,9028,23947,39,15,18,21
58517,445,0,0,70,70,0,1,0,1,0
57361,445,0,0,66,66,0,1,0,1,0
34535,443,2952,443,74325,3719,70606,98,200,44,54
22547,23,0,0,60,60,0,1,0,1,0
52073,443,26285,443,22714,21388,1326,33,30,22,11
56479,53,28725,53,775,103,672,2,30,1,1
45941,23388,0,0,60,60,0,1,0,1,0
1030,35776,0,0,139,139,0,1,0,1,0
14430,443,35759,443,2629,1470,1159,18,15,8,10
65298,53,43096,53,246,102,144,2,30,1,1
56676,53,39365,53,178,94,84,2,31,1,1
65009,53,11589,53,152,78,74,2,30,1,1
61581,443,25669,443,5103,2363,2740,11,120,6,5
64100,445,0,0,66,66,0,1,0,1,0
57411,443,31872,443,214,140,74,4,15,3,1
49477,53,4842,53,178,94,84,2,31,1,1
58638,5900,0,0,62,62,0,1,0,1,0
31281,30188,0,0,62,62,0,1,0,1,0
65115,53,52563,53,193,102,91,2,30,1,1
47274,5223,2647,5223,4269,1451,2818,22,3002,13,9
56636,43890,0,0,66,66,0,1,0,1,0
50547,22197,0,0,66,66,0,1,0,1,0
61123,80,61123,80,21678,2120,19558,33,20,16,17
64257,445,0,0,70,70,0,1,0,1,0
49929,443,35482,443,2484,330,2154,12,136,5,7
49717,443,12194,443,20576,8959,11617,42,130,24,18
50577,80,17204,80,2350,896,1454,13,25,7,6
50398,80,47950,80,318,192,126,6,26,4,2
63228,443,36281,443,3749,2597,1152,25,134,15,10
53060,445,0,0,70,70,0,1,0,1,0
61333,445,0,0,70,70,0,1,0,1,0
33814,22114,0,0,146,146,0,1,0,1,0
52112,443,29903,443,59796,4486,55310,92,48,45,47
50230,445,0,0,70,70,0,1,0,1,0
37647,36237,0,0,66,66,0,1,0,1,0
47478,443,52438,443,4019,1462,2557,21,120,11,10
55043,443,31088,443,11681,3607,8074,40,120,20,20
62916,993,58185,993,8832,3647,5185,77,41,35,42
48983,15000,51295,15000,130,70,60,2,6,1,1
59164,445,0,0,70,70,0,1,0,1,0
53235,445,0,0,70,70,0,1,0,1,0
56119,53,10048,53,199,102,97,2,33,1,1
56256,445,0,0,70,70,0,1,0,1,0
57284,53,19677,53,214,110,104,2,30,1,1
6929,53,6929,53,197,90,107,2,30,1,1
55069,443,55069,443,4517,1610,2907,19,27,11,8
56293,53,1963,53,166,86,80,2,30,1,1
57204,53,58516,53,183,94,89,2,30,1,1
63065,445,0,0,66,66,0,1,0,1,0
56611,53,59791,53,181,94,87,2,31,1,1
32806,7275,35238,7275,130,70,60,2,15,1,1
64874,445,0,0,66,66,0,1,0,1,0
23021,25174,0,0,62,62,0,1,0,1,0
65274,53,37017,53,295,101,194,4,31,2,2
40204,40003,21367,40003,156,94,62,2,30,1,1
14092,80,14092,80,3182,2082,1100,18,86,10,8
61651,123,29529,123,184,94,90,2,30,1,1
46452,53,46452,53,247,98,149,2,32,1,1
52480,443,40106,443,7103,2432,4671,18,76,10,8
63190,35440,0,0,62,62,0,1,0,1,0
36088,443,55123,443,7229,2357,4872,26,270,14,12
3090,1,0,0,62,62,0,1,0,1,0
61753,445,0,0,70,70,0,1,0,1,0
47396,23,0,0,60,60,0,1,0,1,0
49186,53,28433,53,821,102,719,2,30,1,1
54453,443,45461,443,4227,1086,3141,15,29,8,7
49432,53,34624,53,812,110,702,2,30,1,1
56426,80,33168,80,17008,1379,15629,22,25,7,15
49722,53,40518,53,200,102,98,2,31,1,1
47403,57470,0,0,109,109,0,1,0,1,0
65241,53,1849,53,198,102,96,2,30,1,1
50246,445,0,0,70,70,0,1,0,1,0
9179,443,30869,443,5731,495,5236,14,15,7,7
36505,443,41059,443,6293,1501,4792,22,16,11,11
37659,443,25278,443,3354,2353,1001,18,45,11,7
3549,64147,0,0,62,62,0,1,0,1,0
1373,22114,0,0,66,66,0,1,0,1,0
49806,445,0,0,70,70,0,1,0,1,0
33826,443,52979,443,416,210,206,7,57,4,3
52069,53446,32796,53446,70,70,0,1,5,1,0
53251,443,53251,443,1404,697,707,17,121,8,9
64424,53,30245,53,211,102,109,2,30,1,1
52063,80,12503,80,366,240,126,7,26,5,2
20217,8333,0,0,60,60,0,1,0,1,0
51442,443,61245,443,4591,3237,1354,18,271,10,8
49752,53,61999,53,182,94,88,2,30,1,1
50555,445,0,0,70,70,0,1,0,1,0
55469,443,55469,443,4579,1672,2907,19,29,11,8
50568,445,0,0,66,66,0,1,0,1,0
58137,445,0,0,70,70,0,1,0,1,0
64873,53,31946,53,195,94,101,2,31,1,1
54434,445,0,0,70,70,0,1,0,1,0
50129,443,15530,443,9199,2329,6870,30,133,17,13
39540,80,37629,80,130,70,60,2,15,1,1
5588,5588,0,0,3354,1792,1562,46,194,23,23
53615,867,2680,867,70,70,0,1,5,1,0
57727,443,62460,443,54944,4374,50570,88,361,44,44
49734,445,0,0,66,66,0,1,0,1,0
38474,443,30004,443,53562,2314,51248,64,31,24,40
35481,443,52517,443,6804,1473,5331,33,258,15,18
50940,443,27136,443,29500,27698,1802,51,17,29,22
55417,53,60973,53,198,102,96,2,30,1,1
57092,445,0,0,66,66,0,1,0,1,0
64024,445,0,0,70,70,0,1,0,1,0
9283,57470,0,0,66,66,0,1,0,1,0
52793,443,27629,443,1942,1281,661,22,228,16,6
7744,32480,0,0,62,62,0,1,0,1,0
59396,443,16679,443,5801,1995,3806,19,16,10,9
56490,443,32124,443,163763,5320,158443,178,120,60,118
51914,80,46843,80,366,240,126,7,28,5,2
64803,80,9867,80,5518,527,4991,13,75,6,7
63810,27064,25460,27064,1778,1386,392,8,31,4,4
50259,445,0,0,70,70,0,1,0,1,0
62562,445,0,0,70,70,0,1,0,1,0
59691,445,0,0,70,70,0,1,0,1,0
56041,53,26244,53,179,94,85,2,30,1,1
49945,53,3434,53,281,97,184,4,57,2,2
55065,53,9474,53,168,78,90,2,30,1,1
62819,445,0,0,70,70,0,1,0,1,0
65438,443,60459,443,572,320,252,10,28,6,4
50703,80,64252,80,1082,896,186,18,214,15,3
64232,445,0,0,66,66,0,1,0,1,0
50585,445,0,0,70,70,0,1,0,1,0
48978,25174,0,0,66,66,0,1,0,1,0
54876,25174,0,0,146,146,0,1,0,1,0
56810,53,28804,53,177,94,83,2,30,1,1
56995,53,58865,53,168,86,82,2,31,1,1
59920,445,0,0,70,70,0,1,0,1,0
55871,53,54584,53,177,94,83,2,29,1,1
47509,443,17369,443,7769,2586,5183,18,121,9,9
56409,53,61903,53,199,102,97,2,31,1,1
54534,443,41952,443,7153,2581,4572,28,74,15,13
65184,27126,4649,27126,268,78,190,2,29,1,1
64714,445,0,0,70,70,0,1,0,1,0
59018,443,37679,443,1786,172,1614,7,120,3,4
993,38356,0,0,66,66,0,1,0,1,0
61469,443,16667,443,6204,1125,5079,23,89,13,10
443,9986,0,0,152,152,0,1,0,1,0
49447,445,0,0,70,70,0,1,0,1,0
62301,445,0,0,70,70,0,1,0,1,0
55214,445,0,0,70,70,0,1,0,1,0
53972,59089,19075,59089,70,70,0,1,4,1,0
44129,53,44129,53,182,81,101,2,30,1,1
8889,29421,0,0,60,60,0,1,0,1,0
24985,443,23171,443,2227,1018,1209,17,15,8,9
57224,445,0,0,66,66,0,1,0,1,0
45151,53,40658,53,168,78,90,2,30,1,1
55984,445,0,0,66,66,0,1,0,1,0
51673,445,0,0,70,70,0,1,0,1,0
44847,51365,14892,51365,509,150,359,2,1200,1,1
65056,53,34239,53,199,102,97,2,29,1,1
49380,53,10250,53,198,101,97,2,31,1,1
61444,445,0,0,70,70,0,1,0,1,0
16293,57470,0,0,62,62,0,1,0,1,0
55429,25174,0,0,66,66,0,1,0,1,0
41029,53,0,0,86,86,0,1,29,1,0
37067,443,4326,443,21446,1599,19847,35,155,16,19
56523,53,57340,53,168,86,82,2,30,1,1
57157,445,0,0,70,70,0,1,0,1,0
49156,443,29780,443,8569,2165,6404,23,34,12,11
58154,445,0,0,70,70,0,1,0,1,0
53514,8999,20953,8999,70,70,0,1,5,1,0
35745,443,18614,443,7634,4417,3217,35,197,19,16
23270,443,23270,443,5802,2592,3210,24,76,14,10
57867,27019,59183,27019,802,472,330,8,30,5,3
17957,64097,0,0,66,66,0,1,0,1,0
38369,443,64342,443,434,226,208,7,28,4,3
54553,53,62342,53,202,202,0,3,46,3,0
57095,445,0,0,66,66,0,1,0,1,0
50098,445,0,0,70,70,0,1,0,1,0
57356,443,8609,443,7644,3087,4557,26,46,15,11
56246,445,0,0,66,66,0,1,0,1,0
55293,445,0,0,66,66,0,1,0,1,0
56161,62413,0,0,66,66,0,1,0,1,0
31061,23,0,0,60,60,0,1,0,1,0
63964,60705,4477,60705,312,132,180,6,7,3,3
42595,443,31051,443,1093,606,487,11,15,7,4
44695,53,44695,53,198,89,109,2,30,1,1
55606,21802,21715,21802,320,140,180,6,5,3,3
51211,443,40776,443,7638,2405,5233,44,17,25,19
65204,53,50425,53,183,94,89,2,29,1,1
42019,443,22698,443,21620,7973,13647,112,488,57,55
46116,57470,0,0,74,74,0,1,0,1,0
43032,443,31725,443,6792,3009,3783,20,46,12,8
50393,443,41486,443,7356,1014,6342,20,75,10,10
50356,445,0,0,66,66,0,1,0,1,0
54346,443,54346,443,4651,1744,2907,19,27,11,8
65038,445,0,0,66,66,0,1,0,1,0
43096,443,6075,443,3063,1813,1250,18,16,8,10
17873,23117,0,0,66,66,0,1,0,1,0
14578,50584,0,0,66,66,0,1,0,1,0
65258,53,4624,53,186,95,91,2,31,1,1
55875,53,42726,53,228,110,118,2,30,1,1
52237,53,52237,53,220,90,130,2,30,1,1
54270,443,64669,443,29945,19086,10859,98,736,50,48
48290,443,64782,443,7920,2731,5189,27,82,15,12
51922,44847,0,0,62,62,0,1,0,1,0
56240,53,50619,53,748,95,653,2,30,1,1
49418,27019,26998,27019,242,78,164,2,30,1,1
50133,445,0,0,70,70,0,1,0,1,0
64643,53,62127,53,177,94,83,2,30,1,1
53898,12172,10905,12172,70,70,0,2,7,2,0
63953,53,20506,53,426,89,337,4,49,2,2
57385,53,42061,53,177,94,83,2,30,1,1
39852,53,51714,53,223,78,145,2,30,1,1
50717,445,0,0,70,70,0,1,0,1,0
42798,26467,0,0,62,62,0,1,0,1,0
35556,443,35556,443,7201,1167,6034,16,131,8,8
57430,80,9392,80,4509,2976,1533,13,15,6,7
39324,64147,0,0,62,62,0,1,0,1,0
59002,53,19057,53,238,94,144,2,30,1,1
48979,15000,58069,15000,130,70,60,2,5,1,1
56825,16648,32548,16648,164,70,94,2,7,1,1
65231,445,0,0,70,70,0,1,0,1,0
64652,445,0,0,70,70,0,1,0,1,0
59159,445,0,0,70,70,0,1,0,1,0
19841,50584,0,0,62,62,0,1,0,1,0
64811,53,25235,53,193,102,91,2,29,1,1
56556,53,58365,53,184,94,90,2,31,1,1
49691,443,33512,443,1183,659,524,13,56,7,6
50584,49001,36650,49001,1290,300,990,6,1200,3,3
64921,445,0,0,70,70,0,1,0,1,0
25565,52284,0,0,60,60,0,1,0,1,0
48420,26672,0,0,146,146,0,1,0,1,0
23066,443,23066,443,5573,2434,3139,21,25,12,9
38363,5900,0,0,60,60,0,1,0,1,0
45342,443,2921,443,2378,1382,996,20,21,11,9
61850,445,0,0,66,66,0,1,0,1,0
2362,53,2362,53,225,90,135,2,30,1,1
59668,50584,0,0,66,66,0,1,0,1,0
57165,34101,0,0,62,62,0,1,0,1,0
56620,53,43601,53,762,98,664,2,30,1,1
55141,53,48144,53,744,89,655,2,30,1,1
49580,53,62367,53,196,102,94,2,30,1,1
55031,443,25745,443,3625,1378,2247,14,135,7,7
35176,80,37365,80,1987,1329,658,10,136,6,4
51755,5900,0,0,60,60,0,1,0,1,0
30960,45721,23609,45721,66,66,0,1,3600,1,0
48706,23393,0,0,60,60,0,1,0,1,0
60225,443,43705,443,8989,3335,5654,65,152,31,34
45941,23388,0,0,60,60,0,1,0,1,0
51008,445,0,0,70,70,0,1,0,1,0
38770,443,52968,443,140155,6367,133788,173,145,62,111
61636,25735,61636,25735,3828,1516,2312,29,5271,18,11
65189,27015,25924,27015,233,71,162,2,30,1,1
65391,53,47962,53,720,94,626,2,30,1,1
57301,53,33321,53,170,87,83,2,31,1,1
9433,443,31139,443,3299,441,2858,11,15,6,5
53723,443,52693,443,70,70,0,2,8,2,0
65060,53,21160,53,324,97,227,4,52,2,2
59119,445,0,0,70,70,0,1,0,1,0
42237,36237,0,0,66,66,0,1,0,1,0
29195,51505,0,0,146,146,0,1,0,1,0
57157,443,64238,443,1647,1375,272,9,48,5,4
54216,445,0,0,70,70,0,1,0,1,0
52537,57866,0,0,66,66,0,1,0,1,0
64256,53,5483,53,334,94,240,2,31,1,1
63236,445,0,0,70,70,0,1,0,1,0
55325,53,48577,53,198,101,97,2,30,1,1
54133,445,0,0,70,70,0,1,0,1,0
51125,80,6897,80,2880,815,2065,12,25,7,5
52146,80,22638,80,1868,1374,494,12,16,7,5
52975,23718,0,0,66,66,0,1,0,1,0
46034,53,59880,53,168,78,90,2,30,1,1
59781,56205,0,0,66,66,0,1,0,1,0
49234,8080,49234,8080,2604,848,1756,13,136,7,6
41756,56205,0,0,62,62,0,1,0,1,0
54827,443,62409,443,11291,2426,8865,21,121,10,11
50265,57121,42011,57121,132,132,0,3,1200,3,0
47836,443,38604,443,36324,2308,34016,55,81,22,33
50824,443,63186,443,337727,11283,326444,367,208,126,241
51691,80,8687,80,19384,2720,16664,36,174,18,18
3478,61463,0,0,1288,1288,0,1,0,1,0
62057,445,0,0,66,66,0,1,0,1,0
56464,53,58795,53,177,94,83,2,30,1,1
49323,445,0,0,70,70,0,1,0,1,0
53895,53,0,0,86,86,0,1,29,1,0
59146,445,0,0,70,70,0,1,0,1,0
56369,53,59110,53,193,102,91,2,31,1,1
57296,53,27311,53,771,101,670,2,30,1,1
34772,15503,0,0,146,146,0,1,0,1,0
65148,53,60062,53,498,204,294,6,29,3,3
55312,53,37351,53,195,102,93,2,29,1,1
57834,445,0,0,70,70,0,1,0,1,0
64488,53,18852,53,291,102,189,2,29,1,1
58638,5900,0,0,62,62,0,1,0,1,0
58875,443,10382,443,5168,700,4468,16,15,7,9
30765,56205,0,0,66,66,0,1,0,1,0
59676,445,0,0,70,70,0,1,0,1,0
56667,53,19814,53,244,94,150,2,30,1,1
27005,27015,24637,27015,1630,126,1504,4,31,2,2
55015,443,8354,443,1786,172,1614,7,120,3,4
1128,44847,0,0,62,62,0,1,0,1,0
58357,62413,0,0,62,62,0,1,0,1,0
52690,7302,0,0,66,66,0,1,0,1,0
54758,35993,0,0,66,66,0,1,0,1,0
65273,53,14991,53,338,110,228,2,29,1,1
49769,53,30329,53,785,110,675,2,30,1,1
57013,80,33223,80,526,304,222,8,30,5,3
35087,443,32747,443,6053,3586,2467,17,135,8,9
56627,53,58271,53,193,102,91,2,29,1,1
53676,445,0,0,70,70,0,1,0,1,0
52251,445,0,0,70,70,0,1,0,1,0
49597,80,58897,80,372,192,180,7,41,4,3
42332,22114,0,0,66,66,0,1,0,1,0
64989,53,13455,53,167,86,81,2,30,1,1
33884,53,0,0,86,86,0,1,30,1,0
63100,445,0,0,70,70,0,1,0,1,0
53376,445,0,0,70,70,0,1,0,1,0
55411,445,0,0,70,70,0,1,0,1,0
55649,5228,61882,5228,5378,2359,3019,35,3786,16,19
12074,10197,0,0,72,72,0,1,0,1,0
64854,53,19682,53,178,94,84,2,31,1,1
64766,53,59121,53,212,108,104,2,31,1,1
43546,443,49269,443,5948,1664,4284,21,247,12,9
50574,80,15293,80,61763,2941,58822,75,135,33,42
55404,443,57333,443,2352,1394,958,17,275,9,8
55569,443,40443,443,8867,3511,5356,20,120,9,11
51192,15503,0,0,66,66,0,1,0,1,0
26287,56205,0,0,62,62,0,1,0,1,0
53526,445,0,0,70,70,0,1,0,1,0
53182,443,14179,443,16255,8279,7976,42,422,21,21
56803,53,3207,53,429,93,336,4,44,2,2
56619,443,13830,443,7982,1962,6020,20,15,11,9
35554,443,35554,443,4378,1471,2907,19,28,11,8
45964,2225,0,0,60,60,0,1,0,1,0
49855,53,54307,53,212,102,110,2,30,1,1
55256,443,41393,443,3524,2973,551,15,16,9,6
17837,62609,0,0,148,148,0,1,0,1,0
50934,443,28821,443,9989,3003,6986,30,46,17,13
8103,65473,0,0,157,157,0,1,0,1,0
55560,53,1916,53,164,84,80,2,31,1,1
58524,445,0,0,70,70,0,1,0,1,0
59981,443,57380,443,180817,9921,170896,241,21,116,125
5588,5588,0,0,3562,1936,1626,48,195,24,24
48265,443,35728,443,7379,2268,5111,18,134,8,10
55552,53,38672,53,767,102,665,2,30,1,1
49629,53,65217,53,198,102,96,2,31,1,1
64698,53,59784,53,430,106,324,4,58,2,2
33255,53,27087,53,86,86,0,1,30,1,0
59857,445,0,0,66,66,0,1,0,1,0
443,43775,0,0,97,97,0,1,0,1,0
44912,443,31289,443,414,140,274,7,26,3,4
30188,58770,26804,58770,14172,5733,8439,79,1531,37,42
58021,80,10301,80,318,192,126,6,20,4,2
64180,53,29611,53,180,94,86,2,31,1,1
37343,21247,0,0,146,146,0,1,0,1,0
53611,445,0,0,70,70,0,1,0,1,0
56582,53,45513,53,98,98,0,1,30,1,0
60186,445,0,0,70,70,0,1,0,1,0
60713,443,57689,443,6287,1742,4545,17,19,10,7
34319,443,65277,443,15358,11148,4210,93,423,51,42
51959,445,0,0,70,70,0,1,0,1,0
55196,445,0,0,70,70,0,1,0,1,0
56420,443,51933,443,5220,922,4298,17,135,10,7
57492,53,57492,53,218,90,128,2,30,1,1
55951,53,13243,53,197,102,95,2,31,1,1
60251,445,0,0,66,66,0,1,0,1,0
8892,443,11185,443,8106,1626,6480,31,341,11,20
49201,80,60094,80,2986,825,2161,10,135,6,4
43461,35440,0,0,146,146,0,1,0,1,0
55199,53,8107,53,214,110,104,2,30,1,1
64347,53,53125,53,193,102,91,2,29,1,1
64640,53,17711,53,249,94,155,2,30,1,1
61503,443,25661,443,182448,3931,178517,161,26,36,125
60059,445,0,0,66,66,0,1,0,1,0
53921,443,59413,443,499,425,74,4,0,3,1
22409,55442,0,0,74,74,0,1,0,1,0
57743,445,0,0,70,70,0,1,0,1,0
60579,25174,0,0,66,66,0,1,0,1,0
27005,27015,34659,27015,899,126,773,2,30,1,1
55673,54815,52506,54815,316,190,126,5,15,3,2
53450,443,18001,443,5931,1750,4181,24,48,14,10
50127,64147,0,0,66,66,0,1,0,1,0
31660,35440,0,0,66,66,0,1,0,1,0
47357,50584,0,0,62,62,0,1,0,1,0
60878,443,39667,443,31315,6036,25279,65,49,32,33
65263,53,26647,53,356,88,268,4,55,2,2
55390,53,32407,53,778,103,675,2,31,1,1
57268,53,42841,53,205,94,111,2,30,1,1
50470,61463,0,0,86,86,0,1,0,1,0
42732,57470,0,0,62,62,0,1,0,1,0
37738,443,1957,443,6470,1931,4539,27,32,14,13
49961,443,64983,443,16890,7125,9765,33,98,19,14
50559,80,62420,80,318,192,126,6,26,4,2
49372,53,58789,53,216,110,106,2,30,1,1
6666,50070,0,0,60,60,0,1,0,1,0
57204,53,62909,53,195,102,93,2,31,1,1
56101,53,11714,53,194,102,92,2,30,1,1
55820,60038,0,0,66,66,0,1,91,1,0
55012,443,47170,443,3388,2236,1152,28,904,16,12
49874,445,0,0,70,70,0,1,0,1,0
51018,445,0,0,70,70,0,1,0,1,0
64929,53,8681,53,168,86,82,2,31,1,1
58638,5900,0,0,62,62,0,1,0,1,0
65277,53,17756,53,819,102,717,2,31,1,1
44780,80,17326,80,120,120,0,3,122,3,0
65160,443,49536,443,1786,172,1614,7,120,3,4
65065,53,49362,53,754,94,660,2,31,1,1
65189,28125,44608,28125,78,78,0,1,29,1,0
36943,10387,0,0,159,159,0,1,0,1,0
60287,445,0,0,66,66,0,1,0,1,0
49913,445,0,0,70,70,0,1,0,1,0
60438,17372,0,0,66,66,0,1,0,1,0
58701,27030,51697,27030,70,70,0,2,9,2,0
52389,445,0,0,70,70,0,1,0,1,0
53777,62955,56420,62955,70,70,0,1,4,1,0
9439,443,40829,443,6092,775,5317,17,25,9,8
58638,5900,0,0,62,62,0,1,0,1,0
57928,30188,0,0,62,62,0,1,0,1,0
58007,80,40862,80,318,192,126,6,21,4,2
38476,161,0,0,3304,1560,1744,18,30,9,9
52005,443,38700,443,4802,866,3936,19,26,10,9
49247,80,49247,80,135755,6750,129005,160,22,68,92
57521,445,0,0,70,70,0,1,0,1,0
64324,37807,0,0,146,146,0,1,0,1,0
59977,30188,0,0,66,66,0,1,0,1,0
56835,445,0,0,66,66,0,1,0,1,0
6886,55839,0,0,139,139,0,1,0,1,0
64052,38119,11965,38119,312,132,180,6,6,3,3
49418,27015,49804,27015,248,78,170,2,30,1,1
59789,445,0,0,66,66,0,1,0,1,0
35589,25174,0,0,66,66,0,1,0,1,0
60775,443,60775,443,4652,1745,2907,19,29,11,8
51807,445,0,0,70,70,0,1,0,1,0
61143,8080,0,0,60,60,0,1,0,1,0
58103,10197,0,0,66,66,0,1,0,1,0
49843,445,0,0,70,70,0,1,0,1,0
50211,51050,0,0,62,62,0,1,0,1,0
49641,445,0,0,70,70,0,1,0,1,0
56649,443,48324,443,3469,1006,2463,15,121,7,8
65168,53,45025,53,749,94,655,2,30,1,1
58356,443,14561,443,10817,2611,8206,44,135,21,23
49741,53,35577,53,766,102,664,2,30,1,1
51413,25864,0,0,72,72,0,1,0,1,0
49177,53,27104,53,184,94,90,2,30,1,1
49885,7000,49885,7000,3132,815,2317,14,15,7,7
55802,445,0,0,70,70,0,1,0,1,0
44285,25174,0,0,62,62,0,1,0,1,0
2938,64147,0,0,62,62,0,1,0,1,0
50148,80,44851,80,17314,6865,10449,50,79,24,26
57468,57470,0,0,66,66,0,1,0,1,0
52136,42939,1692,42939,70,70,0,1,5,1,0
55665,53,45679,53,229,94,135,2,30,1,1
60803,445,0,0,70,70,0,1,0,1,0
49471,445,0,0,70,70,0,1,0,1,0
49760,1443,52471,1443,626,352,274,10,15,6,4
58638,5900,0,0,62,62,0,1,0,1,0
63344,445,0,0,70,70,0,1,0,1,0
56028,53,49252,53,770,102,668,2,31,1,1
21704,16933,0,0,62,62,0,1,0,1,0
26717,25174,0,0,146,146,0,1,0,1,0
56327,44512,0,0,66,66,0,1,0,1,0
50708,80,26997,80,1658,1247,411,8,15,5,3
63266,445,0,0,70,70,0,1,0,1,0
63717,37965,0,0,66,66,0,1,0,1,0
62341,445,0,0,70,70,0,1,0,1,0
49941,53,13341,53,193,102,91,2,30,1,1
51713,33724,27696,33724,70,70,0,1,5,1,0
49367,51505,0,0,66,66,0,1,0,1,0
39611,443,2531,443,78,78,0,1,5,1,0
42465,443,2367,443,4885,895,3990,16,29,9,7
55392,53,38891,53,190,97,93,2,31,1,1
57425,53,32563,53,168,86,82,2,30,1,1
39244,36829,0,0,146,146,0,1,0,1,0
56119,46824,0,0,62,62,0,1,0,1,0
13840,37965,0,0,146,146,0,1,0,1,0
443,45788,0,0,332,332,0,1,0,1,0
49990,62413,0,0,66,66,0,1,0,1,0
26420,25174,0,0,66,66,0,1,0,1,0
5588,5588,0,0,3354,1792,1562,46,193,23,23
57808,445,0,0,70,70,0,1,0,1,0
52485,443,22795,443,22817,7615,15202,30,16,16,14
52122,43073,59163,43073,70,70,0,1,5,1,0
50108,53,40711,53,179,94,85,2,30,1,1
58725,443,21181,443,26960,13206,13754,53,17,28,25
64623,445,0,0,66,66,0,1,0,1,0
50455,445,0,0,70,70,0,1,0,1,0
51831,445,0,0,66,66,0,1,0,1,0
50800,445,0,0,66,66,0,1,0,1,0
1940,53,23603,53,210,78,132,2,30,1,1
57560,445,0,0,70,70,0,1,0,1,0
60518,80,21543,80,1915,797,1118,8,16,5,3
49980,445,0,0,70,70,0,1,0,1,0
52238,48996,6858,48996,70,70,0,2,4,2,0
53851,443,36931,443,11779,3603,8176,42,142,21,21
56840,20413,2836,20413,66,66,0,1,5,1,0
65237,445,0,0,70,70,0,1,0,1,0
54415,443,40112,443,7129,4391,2738,32,196,16,16
56320,53,14969,53,183,94,89,2,30,1,1
50115,445,0,0,70,70,0,1,0,1,0
64968,53,21697,53,250,102,148,2,31,1,1
55651,445,0,0,70,70,0,1,0,1,0
62888,993,63963,993,8786,4118,4668,80,200,41,39
64041,53,24835,53,200,102,98,2,29,1,1
53161,51221,0,0,66,66,0,1,0,1,0
55757,53,48609,53,177,94,83,2,30,1,1
49663,443,36491,443,4271,1075,3196,16,25,8,8
56646,443,12579,443,7862,1873,5989,20,15,11,9
28235,443,3343,443,8830,2388,6442,29,124,14,15
44783,443,27769,443,4173582,66515,4107067,3494,129,510,2984
9518,57587,0,0,100,100,0,1,0,1,0
53051,44847,0,0,62,62,0,1,0,1,0
23021,2222,0,0,60,60,0,1,0,1,0
5208,63836,0,0,145,145,0,1,0,1,0
34990,80,36946,80,1534,996,538,10,35,6,4
1024,25174,0,0,62,62,0,1,0,1,0
46769,80,58026,80,3589,2432,1157,17,86,9,8
57925,445,0,0,70,70,0,1,0,1,0
54356,443,29580,443,18744,10266,8478,44,35,21,23
51431,445,0,0,70,70,0,1,0,1,0
62888,53,0,0,193,78,115,2,30,1,1
52997,443,41046,443,10754,4129,6625,42,112,20,22
55449,443,46191,443,480989,16896,464093,507,22,178,329
52015,445,0,0,70,70,0,1,0,1,0
56214,53,17373,53,200,102,98,2,30,1,1
53620,445,0,0,70,70,0,1,0,1,0
7744,32480,0,0,62,62,0,1,0,1,0
60722,37965,0,0,62,62,0,1,0,1,0
36828,53,40804,53,168,78,90,2,30,1,1
49855,36180,0,0,62,62,0,1,0,1,0
50728,443,61192,443,34661,17810,16851,89,119,40,49
49386,64147,0,0,62,62,0,1,0,1,0
52555,445,0,0,66,66,0,1,0,1,0
55555,53,19089,53,778,103,675,2,30,1,1
13003,3389,13003,3389,3424,1710,1714,16,33,8,8
51940,80,62105,80,278312,9722,268590,323,61,135,188
56341,53,11727,53,243,94,149,2,30,1,1
64291,445,0,0,66,66,0,1,0,1,0
62331,445,0,0,70,70,0,1,0,1,0
64583,445,0,0,70,70,0,1,0,1,0
45533,80,45533,80,52365,3013,49352,53,51,13,40
63261,445,0,0,66,66,0,1,0,1,0
57470,61467,29646,61467,479,150,329,2,1199,1,1
49853,80,30133,80,15055,6439,8616,26,89,14,12
65024,53,19328,53,199,102,97,2,30,1,1
56667,53,46013,53,168,86,82,2,30,1,1
58853,443,38782,443,59754,9493,50261,131,367,68,63
33886,52255,0,0,162,162,0,1,0,1,0
56560,53,11515,53,198,102,96,2,31,1,1
61250,445,0,0,70,70,0,1,0,1,0
15016,443,15016,443,21083,3108,17975,45,80,24,21
60400,443,24179,443,7073,1556,5517,21,80,11,10
3303,80,51748,80,2338,1419,919,10,15,5,5
57153,445,0,0,70,70,0,1,0,1,0
52086,445,0,0,70,70,0,1,0,1,0
22409,55442,0,0,74,74,0,1,0,1,0
60306,445,0,0,66,66,0,1,0,1,0
63023,51505,0,0,62,62,0,1,0,1,0
38689,443,13215,443,1264333,25315,1239018,1197,16,355,842
51582,48817,0,0,66,66,0,1,0,1,0
49667,53,38974,53,261,94,167,2,30,1,1
50130,53,57806,53,174,89,85,2,30,1,1
54505,445,0,0,66,66,0,1,0,1,0
51877,13472,45197,13472,66,66,0,1,5,1,0
58638,5900,0,0,62,62,0,1,0,1,0
13372,50584,0,0,66,66,0,1,0,1,0
59313,445,0,0,70,70,0,1,0,1,0
52037,45647,32087,45647,316,136,180,6,7,3,3
58896,443,22104,443,5168,700,4468,16,15,7,9
55722,26192,12187,26192,70,70,0,2,8,2,0
49652,53,26066,53,229,110,119,2,30,1,1
55545,3389,55545,3389,3527,1638,1889,18,18,11,7
56353,443,16805,443,3775,1791,1984,24,203,12,12
53286,445,0,0,70,70,0,1,0,1,0
62888,23,0,0,60,60,0,1,0,1,0
56448,53,62354,53,200,102,98,2,29,1,1
54184,443,12378,443,2786,1537,1249,17,16,8,9
54684,37965,0,0,62,62,0,1,0,1,0
63832,6969,32926,6969,70,70,0,1,5,1,0
55857,53,49437,53,196,102,94,2,30,1,1
56757,53,22580,53,322,118,204,2,30,1,1
55056,445,0,0,70,70,0,1,0,1,0
55572,445,0,0,70,70,0,1,0,1,0
53527,45626,13998,45626,70,70,0,1,5,1,0
57859,445,0,0,66,66,0,1,0,1,0
50991,445,0,0,66,66,0,1,0,1,0
60039,80,53912,80,3431,2292,1139,17,142,10,7
50504,443,62477,443,6051,1149,4902,16,25,9,7
7197,80,7197,80,450,246,204,8,31,5,3
50848,445,0,0,66,66,0,1,0,1,0
52214,443,59996,443,10898,3170,7728,33,331,14,19
49640,443,44264,443,12619,3258,9361,33,47,19,14
60874,443,2065,443,777438,37182,740256,940,64,407,533
64935,53,16580,53,765,102,663,2,30,1,1
54879,445,0,0,70,70,0,1,0,1,0
55224,53,26209,53,711,87,624,2,31,1,1
65504,53,13937,53,216,94,122,2,30,1,1
44850,443,60943,443,4502,895,3607,15,25,9,6
44334,26467,0,0,62,62,0,1,0,1,0
57677,57470,0,0,62,62,0,1,0,1,0
53964,443,1978,443,152,78,74,2,5,1,1
18623,1,0,0,66,66,0,1,0,1,0
80,18811,0,0,60,60,0,1,0,1,0
33012,50265,0,0,145,145,0,1,0,1,0
57427,445,0,0,70,70,0,1,0,1,0
57384,53,45393,53,752,93,659,2,31,1,1
65165,53,27998,53,783,96,687,2,31,1,1
61830,445,0,0,70,70,0,1,0,1,0
53713,80,58765,80,5778,661,5117,17,75,8,9
47733,443,46776,443,556154,55291,500863,1146,559,440,706
25583,2323,0,0,60,60,0,1,0,1,0
52182,53,52182,53,832,106,726,2,30,1,1
42151,53,3505,53,168,78,90,2,30,1,1
63847,445,0,0,70,70,0,1,0,1,0
50706,443,45520,443,13948,10445,3503,25,121,14,11
9231,3389,0,0,66,66,0,1,0,1,0
49502,443,21667,443,26402,2904,23498,56,270,29,27
56946,1,0,0,66,66,0,1,0,1,0
1043,48817,0,0,136,136,0,1,0,1,0
49889,80,51133,80,1376,946,430,8,87,5,3
52431,443,19671,443,7396,3677,3719,16,120,8,8
52085,445,0,0,66,66,0,1,0,1,0
50575,80,50575,80,44569,12221,32348,81,19,42,39
23122,26296,0,0,159,159,0,1,0,1,0
52221,53,60196,53,164,78,86,2,29,1,1
55999,443,22014,443,3640,606,3034,13,120,6,7
55260,53,54111,53,183,94,89,2,30,1,1
55560,443,48574,443,7047,1994,5053,20,24,12,8
45313,64147,0,0,62,62,0,1,0,1,0
56544,443,41897,443,39717,3740,35977,76,53,39,37
52827,445,0,0,70,70,0,1,0,1,0
64289,53,28932,53,199,102,97,2,30,1,1
63941,53,9002,53,228,94,134,2,30,1,1
52018,80,20950,80,1660,791,869,11,32,6,5
49749,80,64733,80,230959,4381,226578,217,91,60,157
5213,44847,0,0,66,66,0,1,0,1,0
53913,28402,8057,28402,70,70,0,1,4,1,0
21482,22114,0,0,62,62,0,1,0,1,0
60033,443,16938,443,2845,1765,1080,15,142,8,7
49514,65504,0,0,162,162,0,1,0,1,0
49628,445,0,0,70,70,0,1,0,1,0
50809,445,0,0,66,66,0,1,0,1,0
58638,5900,0,0,62,62,0,1,0,1,0
60136,443,31780,443,21278,12533,8745,57,183,36,21
53233,443,53233,443,4114,2535,1579,25,139,13,12
56757,53,3651,53,783,96,687,2,31,1,1
60407,443,16001,443,7298,1737,5561,21,79,11,10
51964,443,11131,443,5363,2713,2650,26,53,14,12
15978,50584,0,0,146,146,0,1,0,1,0
55439,53,52898,53,209,110,99,2,30,1,1
53771,57470,0,0,66,66,0,1,0,1,0
55046,53,5301,53,300,102,198,4,40,2,2
49106,53,49106,53,1415,689,726,3,30,2,1
49588,443,55419,443,5879,870,5009,18,53,9,9
49752,50584,0,0,62,62,0,1,0,1,0
56822,53,28434,53,184,94,90,2,30,1,1
56386,50584,0,0,62,62,0,1,0,1,0
56769,53,26341,53,195,102,93,2,30,1,1
42611,443,22505,443,5559,1639,3920,21,186,12,9
60222,445,0,0,70,70,0,1,0,1,0
56413,53,33044,53,338,110,228,2,30,1,1
42366,57470,0,0,66,66,0,1,0,1,0
50571,80,62731,80,318,192,126,6,26,4,2
53818,15337,22779,15337,258,70,188,4,8,2,2
50977,56205,0,0,66,66,0,1,0,1,0
57470,6969,5895,6969,132,132,0,3,1199,3,0
59475,53,33895,53,179,86,93,2,30,1,1
44099,443,23895,443,8049289,98432,7950857,6501,125,717,5784
60396,443,5888,443,5964,1586,4378,19,80,10,9
0,0,0,0,98,98,0,1,0,1,0
61981,443,61981,443,4533,1626,2907,19,29,11,8
60263,445,0,0,70,70,0,1,0,1,0
36405,53,36515,53,199,94,105,2,30,1,1
56910,53,22546,53,199,102,97,2,29,1,1
65420,443,40711,443,3213,2242,971,19,25,9,10
58000,80,21507,80,48253,13664,34589,66,75,25,41
1035,26467,0,0,62,62,0,1,0,1,0
59038,53,59038,53,832,106,726,2,30,1,1
53758,63975,2179,63975,2016,1076,940,14,17,8,6
57385,53,40272,53,194,99,95,2,31,1,1
61461,50584,0,0,62,62,0,1,0,1,0
56369,53,50667,53,168,86,82,2,29,1,1
56710,80,31559,80,30614,1926,28688,44,45,23,21
55810,53,11576,53,183,94,89,2,29,1,1
33401,51505,0,0,66,66,0,1,0,1,0
57634,445,0,0,66,66,0,1,0,1,0
49179,80,7093,80,2807,587,2220,13,16,7,6
58638,5900,0,0,62,62,0,1,0,1,0
59276,443,40586,443,16232,3319,12913,23,125,9,14
60011,443,4713,443,11061,2230,8831,40,109,23,17
54700,445,0,0,70,70,0,1,0,1,0
55848,53,34320,53,168,86,82,2,30,1,1
47534,443,60052,443,291717,11752,279965,319,137,123,196
21189,53,21189,53,374,240,134,3,32,2,1
64226,53,55510,53,211,102,109,2,30,1,1
58919,443,29317,443,5166,700,4466,16,15,7,9
65098,445,0,0,70,70,0,1,0,1,0
58135,445,0,0,70,70,0,1,0,1,0
3559,30188,0,0,66,66,0,1,0,1,0
63117,7000,63117,7000,4067,1750,2317,16,15,9,7
33305,443,50193,443,1067,650,417,10,73,6,4
58608,62413,0,0,66,66,0,1,0,1,0
26553,57470,0,0,62,62,0,1,0,1,0
50969,80,54293,80,921711,12229,909482,780,37,172,608
50460,443,36423,443,5572,4252,1320,18,34,11,7
61147,22114,0,0,66,66,0,1,0,1,0
53097,25174,0,0,62,62,0,1,0,1,0
58220,445,0,0,70,70,0,1,0,1,0
55045,443,26442,443,5541,2778,2763,24,15,14,10
51295,443,51295,443,4334,1427,2907,19,27,11,8
64384,53,2219,53,333,94,239,2,30,1,1
2001,80,2001,80,1535,652,883,9,16,5,4
55261,445,0,0,70,70,0,1,0,1,0
14360,64147,0,0,62,62,0,1,0,1,0
56875,53,43240,53,167,86,81,2,30,1,1
46081,443,10510,443,125213,5113,120100,153,96,58,95
49593,5228,25502,5228,9720,2717,7003,67,1019,34,33
58638,5900,0,0,62,62,0,1,0,1,0
57997,80,61005,80,318,192,126,6,21,4,2
58899,445,0,0,70,70,0,1,0,1,0
54053,443,54053,443,1468,763,705,16,181,8,8
50177,445,0,0,70,70,0,1,0,1,0
57575,443,3355,443,707158,36853,670305,902,148,310,592
56730,443,7897,443,347884,9284,338600,360,31,125,235
64877,37450,0,0,62,62,0,1,0,1,0
27005,27269,13554,27269,886,126,760,2,30,1,1
14333,51050,0,0,62,62,0,1,0,1,0
61303,445,0,0,70,70,0,1,0,1,0
63724,23,0,0,60,60,0,1,0,1,0
61808,445,0,0,70,70,0,1,0,1,0
57025,53,3380,53,168,86,82,2,31,1,1
41247,80,52056,80,234,234,0,4,12,4,0
55915,53,47313,53,86,86,0,1,30,1,0
63672,22114,0,0,66,66,0,1,0,1,0
14185,48637,0,0,60,60,0,1,0,1,0
62744,445,0,0,66,66,0,1,0,1,0
59601,443,24962,443,162,102,60,2,5,1,1
10088,37807,0,0,66,66,0,1,0,1,0
57015,25174,0,0,66,66,0,1,0,1,0
53827,5889,21032,5889,70,70,0,2,7,2,0
48067,443,48553,443,12648,5285,7363,58,32,27,31
56949,443,2703,443,5601,1203,4398,14,59,9,5
1373,22114,0,0,62,62,0,1,0,1,0
50606,445,0,0,66,66,0,1,0,1,0
53975,40978,50066,40978,1946,1019,927,10,15,6,4
65313,53,63714,53,164,84,80,2,31,1,1
63654,443,35757,443,9152483,314975,8837508,9599,206,3195,6404
50594,80,12498,80,1635,824,811,10,15,5,5
56131,445,0,0,66,66,0,1,0,1,0
62548,445,0,0,70,70,0,1,0,1,0
49476,53,34696,53,764,102,662,2,30,1,1
50462,80,58102,80,4603,2152,2451,14,22,8,6
63651,443,19234,443,333668,12291,321377,321,170,72,249
53102,53,13819,53,70,70,0,1,30,1,0
59192,25174,0,0,66,66,0,1,0,1,0
50958,53,61318,53,94,94,0,1,30,1,0
55567,53,51894,53,184,80,104,2,0,1,1
47655,53,46246,53,168,78,90,2,29,1,1
63691,80,13237,80,314,192,122,6,15,4,2
49418,27016,64137,27016,270,78,192,2,30,1,1
53164,443,1379,443,7434,1695,5739,23,27,12,11
57246,53,12592,53,183,94,89,2,30,1,1
58230,64147,0,0,66,66,0,1,0,1,0
64989,50265,0,0,66,66,0,1,0,1,0
59581,445,0,0,70,70,0,1,0,1,0
64751,53,29777,53,172,88,84,2,30,1,1
62120,443,62120,443,4378,1471,2907,19,27,11,8
52354,445,0,0,70,70,0,1,0,1,0
60946,443,58938,443,1373,712,661,14,18,8,6
53892,443,6388,443,499,425,74,4,0,3,1
36402,80,36402,80,1917,1468,449,10,20,6,4
65221,445,0,0,70,70,0,1,0,1,0
65526,28793,0,0,62,62,0,1,0,1,0
49636,53,12225,53,180,94,86,2,30,1,1
60167,5222,36653,5222,908,650,258,11,20,7,4
60519,445,0,0,70,70,0,1,0,1,0
64441,445,0,0,70,70,0,1,0,1,0
27005,28515,30330,28515,1660,126,1534,4,30,2,2
59062,445,0,0,70,70,0,1,0,1,0
65514,53,14703,53,214,110,104,2,29,1,1
58638,5900,0,0,62,62,0,1,0,1,0
56186,53,3994,53,198,102,96,2,29,1,1
55352,53,6913,53,216,110,106,2,31,1,1
58198,445,0,0,70,70,0,1,0,1,0
48371,53,57320,53,198,93,105,2,30,1,1
26900,27017,21436,27017,422,164,258,6,30,3,3
64738,53,34025,53,402,118,284,2,30,1,1
59785,14914,0,0,143,143,0,1,0,1,0
80,56289,0,0,1090,1090,0,1,0,1,0
59402,53,59402,53,216,90,126,2,29,1,1
14252,35993,0,0,62,62,0,1,0,1,0
12821,37965,0,0,66,66,0,1,0,1,0
55408,64147,0,0,66,66,0,1,0,1,0
53689,445,0,0,70,70,0,1,0,1,0
50927,80,64147,80,876,519,357,10,75,6,4
58638,5900,0,0,62,62,0,1,0,1,0
57416,53,8404,53,193,102,91,2,29,1,1
49534,53,17481,53,315,84,231,4,40,2,2
53946,27426,37838,27426,612,306,306,10,14,5,5
53723,51501,24523,51501,70,70,0,1,5,1,0
53751,445,0,0,70,70,0,1,0,1,0
65228,53,51061,53,267,93,174,4,46,2,2
49688,443,44354,443,318,192,126,6,53,4,2
50711,80,56692,80,708,384,324,12,195,7,5
61550,5529,0,0,145,145,0,1,0,1,0
62334,443,24621,443,3244,1630,1614,8,120,4,4
62895,993,31409,993,10457,4879,5578,98,186,50,48
27988,40002,58461,40002,144,82,62,2,31,1,1
39640,53,64225,53,168,78,90,2,30,1,1
64235,53,30515,53,321,99,222,4,52,2,2
49203,53,34232,53,195,102,93,2,30,1,1
51892,445,0,0,66,66,0,1,0,1,0
45941,23386,0,0,60,60,0,1,0,1,0
55006,443,44050,443,2900,2007,893,20,36,12,8
58563,53,4425,53,312,78,234,2,29,1,1
48658,53,48919,53,368,80,288,4,30,2,2
50772,35440,0,0,66,66,0,1,0,1,0
63624,445,0,0,70,70,0,1,0,1,0
4910,2149,0,0,62,62,0,1,0,1,0
54848,445,0,0,70,70,0,1,0,1,0
58956,80,51257,80,2493,1830,663,12,15,6,6
56684,53,5087,53,194,94,100,2,30,1,1
56388,53,23027,53,186,95,91,3,34,2,1
51499,443,64851,443,43980,3500,40480,65,16,31,34
56322,53,24189,53,209,110,99,2,30,1,1
64231,445,0,0,70,70,0,1,0,1,0
56984,80,27269,80,214,140,74,4,35,3,1
53767,10004,34912,10004,70,70,0,2,7,2,0
56873,53,37492,53,184,94,90,2,30,1,1
8881,443,2247,443,27459,19126,8333,67,402,30,37
51528,445,0,0,66,66,0,1,0,1,0
55836,445,0,0,70,70,0,1,0,1,0
52406,443,12118,443,11463,850,10613,23,25,7,16
63855,445,0,0,66,66,0,1,0,1,0
55027,53,14460,53,177,94,83,2,29,1,1
55357,445,0,0,70,70,0,1,0,1,0
10001,40041,23223,40041,151,89,62,2,30,1,1
64883,445,0,0,70,70,0,1,0,1,0
47091,5228,39353,5228,3113,1395,1718,20,3608,8,12
55427,64147,0,0,66,66,0,1,0,1,0
60487,445,0,0,66,66,0,1,0,1,0
10035,443,49026,443,7915,1634,6281,25,315,11,14
64908,445,0,0,66,66,0,1,0,1,0
55509,445,0,0,70,70,0,1,0,1,0
36881,56205,0,0,146,146,0,1,0,1,0
54828,443,1359,443,150,150,0,1,5,1,0
54136,80,22556,80,25148,5233,19915,39,71,21,18
59406,445,0,0,70,70,0,1,0,1,0
55739,53,43741,53,215,102,113,2,30,1,1
59489,445,0,0,70,70,0,1,0,1,0
64752,53,32902,53,186,102,84,2,30,1,1
27402,37628,0,0,62,62,0,1,0,1,0
49845,53,6637,53,188,96,92,2,31,1,1
50307,80,5299,80,2840,1750,1090,13,82,7,6
53928,15503,0,0,62,62,0,1,0,1,0
52859,445,0,0,66,66,0,1,0,1,0
54887,443,54887,443,5573,2326,3247,22,40,13,9
54981,53,59429,53,757,102,655,2,29,1,1
50997,445,0,0,70,70,0,1,0,1,0
58053,445,0,0,66,66,0,1,0,1,0
50523,53,7142,53,168,86,82,2,31,1,1
49875,445,0,0,70,70,0,1,0,1,0
52988,53567,0,0,66,66,0,1,0,1,0
60159,22114,0,0,66,66,0,1,0,1,0
65448,53,6069,53,264,110,154,2,30,1,1
56843,445,0,0,70,70,0,1,0,1,0
49444,53,22362,53,212,102,110,2,30,1,1
59493,44847,0,0,66,66,0,1,0,1,0
14438,443,5069,443,2556,1470,1086,17,15,8,9
49234,53,44202,53,167,86,81,2,30,1,1
31132,53,31132,53,227,89,138,2,30,1,1
53107,44060,63943,44060,70,70,0,2,8,2,0
50516,53,48548,53,772,100,672,2,31,1,1
49424,53,36639,53,210,102,108,2,30,1,1
30728,53,30728,53,196,88,108,2,30,1,1
65189,53,27284,53,180,94,86,2,30,1,1
62983,445,0,0,66,66,0,1,0,1,0
63173,36237,0,0,66,66,0,1,0,1,0
54315,445,0,0,70,70,0,1,0,1,0
54262,53,54262,53,216,82,134,2,33,1,1
54826,56205,0,0,66,66,0,1,0,1,0
64884,53,27376,53,195,102,93,2,31,1,1
52127,80,9783,80,2412,1750,662,13,36,9,4
45755,443,42960,443,1625,1038,587,14,26,8,6
50281,5223,28986,5223,208,60,148,4,11,2,2
46641,8100,13057,8100,78,78,0,1,4,1,0
49418,27015,5163,27015,265,78,187,2,31,1,1
46090,50584,0,0,62,62,0,1,0,1,0
41620,53,41620,53,257,101,156,2,32,1,1
53980,36153,5182,36153,258,70,188,4,7,2,2
65422,26467,0,0,62,62,0,1,0,1,0
44949,443,16538,443,4093,2830,1263,21,24,11,10
22274,53,9607,53,278,78,200,2,30,1,1
50799,445,0,0,66,66,0,1,0,1,0
58962,445,0,0,70,70,0,1,0,1,0
53572,443,49621,443,5935,342,5593,12,120,5,7
1070,26467,0,0,62,62,0,1,0,1,0
55417,53,14562,53,199,102,97,2,30,1,1
53510,445,0,0,70,70,0,1,0,1,0
64974,53,44237,53,212,108,104,2,31,1,1
55538,53,15605,53,168,86,82,2,30,1,1
56249,445,0,0,70,70,0,1,0,1,0
58681,443,24073,443,22576,10533,12043,61,200,35,26
59758,445,0,0,70,70,0,1,0,1,0
36387,443,45505,443,7139,1751,5388,32,1372,10,22
57346,53,23622,53,210,110,100,2,29,1,1
55884,445,0,0,66,66,0,1,0,1,0
49380,443,11402,443,2382775,72482,2310293,2485,252,843,1642
34215,443,33625,443,5341,1386,3955,19,649,11,8
80,9918,0,0,60,60,0,1,0,1,0
55752,53,39716,53,177,94,83,2,30,1,1
52089,16543,21777,16543,70,70,0,2,9,2,0
37371,5228,12391,5228,3277,1954,1323,27,3600,14,13
54210,64097,0,0,66,66,0,1,0,1,0
59420,53,63231,53,224,78,146,2,30,1,1
51443,443,42123,443,322,262,60,2,15,1,1
58638,5900,0,0,62,62,0,1,0,1,0
56131,53,25151,53,245,94,151,2,30,1,1
50669,443,37355,443,12463,2350,10113,46,20,19,27
56743,53,62302,53,209,110,99,2,31,1,1
56135,53,30728,53,258,118,140,2,30,1,1
443,23220,0,0,100,100,0,1,0,1,0
64292,53,10616,53,387,94,293,4,51,2,2
48965,443,50088,443,9519,4377,5142,33,354,17,16
50886,445,0,0,70,70,0,1,0,1,0
50486,56205,0,0,62,62,0,1,0,1,0
63641,445,0,0,66,66,0,1,0,1,0
16522,26467,0,0,62,62,0,1,0,1,0
58488,37965,0,0,62,62,0,1,0,1,0
59843,443,50473,443,1427,726,701,17,46,8,9
50258,5228,5532,5228,6764,1575,5189,25,157,14,11
58568,445,0,0,70,70,0,1,0,1,0
64910,53,52147,53,259,86,173,2,30,1,1
63827,445,0,0,70,70,0,1,0,1,0
52673,80,57831,80,23776,1372,22404,35,112,15,20
6889,9074,0,0,143,143,0,1,0,1,0
55484,53,28906,53,711,87,624,2,30,1,1
57768,37965,0,0,66,66,0,1,0,1,0
26900,27017,38585,27017,6466,3520,2946,38,46,21,17
64533,53,56786,53,183,102,81,2,29,1,1
35205,53,35205,53,240,98,142,2,30,1,1
56388,53,20730,53,275,95,180,4,44,2,2
59772,62413,0,0,62,62,0,1,0,1,0
64613,53,11249,53,212,102,110,2,30,1,1
64945,53,32076,53,733,94,639,2,30,1,1
43205,22,43205,22,6957,2330,4627,35,27,17,18
64473,53,39348,53,184,94,90,2,31,1,1
57470,56250,44821,56250,330,330,0,6,1199,6,0
55098,53,33176,53,474,200,274,6,44,3,3
60286,443,29238,443,7576,1897,5679,23,136,13,10
65130,445,0,0,66,66,0,1,0,1,0
13985,34159,0,0,62,62,0,1,0,1,0
62418,445,0,0,66,66,0,1,0,1,0
51560,445,0,0,70,70,0,1,0,1,0
43402,53,65461,53,241,78,163,2,30,1,1
58638,5900,0,0,62,62,0,1,0,1,0
58638,5900,0,0,62,62,0,1,0,1,0
64695,445,0,0,70,70,0,1,0,1,0
63318,445,0,0,70,70,0,1,0,1,0
55851,53,15581,53,749,94,655,2,30,1,1
43560,443,3098,443,8964,2125,6839,34,120,18,16
51880,51881,42143,51881,86,86,0,1,30,1,0
51234,445,0,0,66,66,0,1,0,1,0
64627,53,39841,53,199,102,97,2,31,1,1
44922,57470,0,0,74,74,0,1,0,1,0
58578,445,0,0,70,70,0,1,0,1,0
61185,54532,0,0,62,62,0,1,0,1,0
49380,445,0,0,70,70,0,1,0,1,0
16524,22114,0,0,62,62,0,1,0,1,0
44147,64147,0,0,62,62,0,1,0,1,0
51522,445,0,0,66,66,0,1,0,1,0
55391,53,33139,53,210,110,100,2,30,1,1
49723,53,26637,53,209,110,99,2,30,1,1
62645,445,0,0,70,70,0,1,0,1,0
51503,443,40605,443,4801,702,4099,13,16,8,5
52894,443,46843,443,5424,1445,3979,29,117,14,15
65514,53,6429,53,212,108,104,2,31,1,1
52747,445,0,0,66,66,0,1,0,1,0
53948,445,0,0,70,70,0,1,0,1,0
56360,445,0,0,70,70,0,1,0,1,0
6881,10104,0,0,107,107,0,1,0,1,0
54369,445,0,0,70,70,0,1,0,1,0
59793,443,44894,443,41635,3977,37658,63,121,25,38
58638,5900,0,0,62,62,0,1,0,1,0
23089,48817,0,0,62,62,0,1,0,1,0
48852,443,7799,443,38886,2134,36752,55,16,24,31
56577,53,39696,53,182,94,88,2,30,1,1
43363,26467,0,0,66,66,0,1,0,1,0
56953,443,22328,443,7245,1282,5963,16,135,7,9
9122,80,61976,80,98161,5033,93128,125,37,45,80
63798,16357,18681,16357,66,66,0,2,8,2,0
62519,445,0,0,70,70,0,1,0,1,0
62082,445,0,0,70,70,0,1,0,1,0
3478,61463,0,0,503,503,0,1,0,1,0
50450,53,51972,53,209,110,99,2,30,1,1
50483,443,61825,443,12462,2612,9850,37,80,19,18
28316,3389,28316,3389,4695,2520,2175,22,19,13,9
55531,53,31789,53,216,110,106,2,30,1,1
57441,57470,0,0,66,66,0,1,0,1,0
49849,53,11014,53,196,102,94,2,30,1,1
56638,64147,0,0,62,62,0,1,0,1,0
38066,443,48945,443,328599,275779,52820,868,342,483,385
50682,445,0,0,70,70,0,1,0,1,0
27000,23117,0,0,62,62,0,1,0,1,0
51509,24855,0,0,66,66,0,1,90,1,0
50530,445,0,0,66,66,0,1,0,1,0
53798,62166,11396,62166,258,70,188,4,7,2,2
55223,53,31444,53,168,86,82,2,30,1,1
62069,443,28586,443,38455,5252,33203,71,60,41,30
60628,445,0,0,70,70,0,1,0,1,0
54617,64147,0,0,62,62,0,1,0,1,0
52287,445,0,0,66,66,0,1,0,1,0
65436,53,10665,53,102,102,0,1,30,1,0
15345,36829,0,0,66,66,0,1,0,1,0
53161,51221,0,0,66,66,0,1,0,1,0
64135,53,40678,53,196,102,94,2,30,1,1
63046,445,0,0,70,70,0,1,0,1,0
57486,80,57486,80,1248,535,713,10,20,5,5
62386,37965,0,0,66,66,0,1,0,1,0
41029,80,41029,80,12386,2651,9735,24,126,12,12
54352,53,16730,53,578,286,292,9,16,5,4
60193,445,0,0,66,66,0,1,0,1,0
55098,53,15101,53,474,200,274,6,43,3,3
56504,53,24881,53,198,102,96,2,32,1,1
5200,6643,0,0,145,145,0,1,0,1,0
53031,443,28915,443,2399,1799,600,15,120,10,5
53712,25174,0,0,66,66,0,1,0,1,0
9245,80,28513,80,378,192,186,7,26,4,3
46987,443,53868,443,8688,3211,5477,24,343,11,13
12737,35440,0,0,62,62,0,1,0,1,0
64681,35993,0,0,66,66,0,1,0,1,0
49402,53,18505,53,214,110,104,2,30,1,1
49891,53,30480,53,788,108,680,2,31,1,1
1091,37965,0,0,62,62,0,1,0,1,0
59375,445,0,0,70,70,0,1,0,1,0
49324,53,24551,53,258,94,164,2,30,1,1
39981,57470,0,0,62,62,0,1,0,1,0
37651,443,37651,443,4659,1752,2907,19,30,11,8
49989,53,26196,53,346,111,235,2,30,1,1
54601,26467,0,0,66,66,0,1,0,1,0
65528,53,22092,53,199,86,113,2,29,1,1
21519,443,21519,443,14483,1152,13331,27,19,12,15
40215,443,8042,443,6423,1543,4880,21,191,12,9
6881,37232,47143,37232,502,150,352,2,1199,1,1
49531,26467,0,0,66,66,0,1,0,1,0
57629,445,0,0,70,70,0,1,0,1,0
27005,27017,42794,27017,880,126,754,2,30,1,1
50454,445,0,0,70,70,0,1,0,1,0
56734,80,64954,80,194,128,66,4,25,3,1
50779,443,64325,443,3247,1630,1617,8,120,4,4
58289,445,0,0,70,70,0,1,0,1,0
59810,6004,0,0,66,66,0,1,0,1,0
55235,53,18331,53,178,94,84,2,29,1,1
45896,443,32975,443,1160457,45088,1115369,1320,315,518,802
61513,445,0,0,66,66,0,1,0,1,0
49323,53,61963,53,196,102,94,2,30,1,1
52056,80,64858,80,4562,3936,626,11,28,6,5
45118,39004,0,0,74,74,0,1,0,1,0
55254,443,12972,443,3257,782,2475,17,140,8,9
33042,443,32323,443,130,70,60,2,14,1,1
49699,53,49094,53,209,110,99,2,30,1,1
50433,443,11749,443,134,60,74,3,10,2,1
56614,80,65163,80,234,234,0,4,11,4,0
37007,22114,0,0,146,146,0,1,0,1,0
60416,37965,0,0,66,66,0,1,0,1,0
55616,56205,0,0,62,62,0,1,0,1,0
64401,53,5392,53,293,94,199,2,30,1,1
6712,123,0,0,90,90,0,1,0,1,0
52363,123,30662,123,184,94,90,2,30,1,1
63877,445,0,0,70,70,0,1,0,1,0
56454,445,0,0,70,70,0,1,0,1,0
46945,64147,0,0,62,62,0,1,0,1,0
50916,80,44611,80,11456216,116932,11339284,9298,139,1683,7615
55975,53,27530,53,939,678,261,2,30,1,1
50279,53,54207,53,749,94,655,2,29,1,1
49295,53,60068,53,172,94,78,2,30,1,1
56628,80,40894,80,234,234,0,4,11,4,0
54146,445,0,0,70,70,0,1,0,1,0
50312,445,0,0,70,70,0,1,0,1,0
50154,53,53091,53,756,95,661,2,30,1,1
50317,443,44223,443,13565,6019,7546,35,112,19,16
64885,53,54457,53,182,102,80,2,31,1,1
54810,80,61461,80,6098,1916,4182,31,357,16,15
55095,53,63653,53,194,102,92,2,29,1,1
64087,80,46757,80,314,192,122,6,15,4,2
65266,53,53450,53,233,102,131,2,29,1,1
58207,51505,0,0,66,66,0,1,0,1,0
52696,21247,0,0,62,62,0,1,0,1,0
51811,445,0,0,70,70,0,1,0,1,0
60755,40010,18324,40010,316,136,180,6,7,3,3
49797,25174,0,0,66,66,0,1,0,1,0
42964,5900,0,0,60,60,0,1,0,1,0
62635,445,0,0,66,66,0,1,0,1,0
57574,443,28846,443,3595,1957,1638,17,361,9,8
57470,20433,47061,20433,726,726,0,12,1200,12,0
47975,443,46443,443,8301,2172,6129,25,255,12,13
42731,23,0,0,60,60,0,1,0,1,0
56596,53,43071,53,194,102,92,2,30,1,1
62872,50584,0,0,66,66,0,1,0,1,0
56343,53,52506,53,177,94,83,2,29,1,1
55636,25569,50876,25569,320,140,180,6,6,3,3
65467,443,32500,443,92244,4799,87445,107,15,43,64
54313,445,0,0,66,66,0,1,0,1,0
49233,443,34014,443,9622,3524,6098,59,916,29,30
55516,445,0,0,70,70,0,1,0,1,0
39630,443,32291,443,70,70,0,1,5,1,0
8889,49138,0,0,60,60,0,1,0,1,0
48831,443,51436,443,10129,5016,5113,18,120,9,9
7444,57470,0,0,66,66,0,1,0,1,0
26566,44847,0,0,66,66,0,1,0,1,0
50031,53,15521,53,181,94,87,2,30,1,1
51825,25501,31893,25501,66,66,0,1,5,1,0
50470,53,11331,53,770,102,668,2,30,1,1
63970,53,14367,53,200,94,106,2,30,1,1
6881,6881,0,0,62,62,0,1,0,1,0
59477,443,16193,443,7825,4076,3749,19,121,10,9
53517,445,0,0,66,66,0,1,0,1,0
43027,80,42429,80,1506,1446,60,2,5,1,1
26601,22114,0,0,62,62,0,1,0,1,0
18655,44847,0,0,66,66,0,1,0,1,0
50994,445,0,0,66,66,0,1,0,1,0
58672,43890,0,0,66,66,0,1,0,1,0
9472,443,45589,443,5699,505,5194,14,15,7,7
58443,443,26143,443,12060,3749,8311,42,17,23,19
64881,445,0,0,66,66,0,1,0,1,0
60183,445,0,0,70,70,0,1,0,1,0
56111,445,0,0,70,70,0,1,0,1,0
60698,445,0,0,70,70,0,1,0,1,0
49846,443,59260,443,278883,9002,269881,313,72,115,198
5617,64147,0,0,62,62,0,1,0,1,0
49601,53,32118,53,178,94,84,2,30,1,1
59893,53,45221,53,198,93,105,2,30,1,1
53877,445,0,0,66,66,0,1,0,1,0
37075,3389,37075,3389,293,223,70,4,1,3,1
57340,53,3053,53,747,92,655,2,31,1,1
60395,443,53609,443,10672,1729,8943,24,81,12,12
16518,64147,0,0,145,145,0,1,0,1,0
53512,23280,49318,23280,1950,957,993,17,17,10,7
43014,53,60826,53,198,93,105,2,30,1,1
56818,60043,0,0,66,66,0,1,0,1,0
56942,53,10682,53,177,94,83,2,31,1,1
42642,443,27903,443,6826,1804,5022,21,137,11,10
51803,33973,32167,33973,66,66,0,1,5,1,0
57282,53,23204,53,199,102,97,2,29,1,1
55323,443,19578,443,229587,8510,221077,245,121,82,163
55716,36989,39721,36989,320,140,180,6,6,3,3
65507,53,62722,53,177,94,83,2,30,1,1
63694,445,0,0,66,66,0,1,0,1,0
65165,53,58294,53,200,102,98,2,31,1,1
7665,80,7665,80,110567,7016,103551,135,46,60,75
52401,445,0,0,70,70,0,1,0,1,0
53192,445,0,0,70,70,0,1,0,1,0
14309,56205,0,0,62,62,0,1,0,1,0
56935,53,62999,53,198,102,96,2,30,1,1
27005,27054,8800,27054,921,126,795,2,31,1,1
35978,443,55185,443,2959,793,2166,10,120,5,5
57034,445,0,0,66,66,0,1,0,1,0
58415,443,33034,443,560,280,280,9,30,5,4
57378,53,5726,53,350,94,256,2,30,1,1
33582,44847,0,0,62,62,0,1,0,1,0
51100,445,0,0,70,70,0,1,0,1,0
21542,57470,0,0,74,74,0,1,0,1,0
65484,53,10578,53,195,86,109,2,30,1,1
56678,443,37527,443,4099,2450,1649,36,2615,19,17
65108,53,46911,53,195,94,101,2,29,1,1
50100,53,23176,53,216,110,106,2,30,1,1
64595,53,24899,53,167,86,81,2,29,1,1
25015,64147,0,0,66,66,0,1,0,1,0
61026,445,0,0,66,66,0,1,0,1,0
47037,1,0,0,62,62,0,1,0,1,0
49234,53,56023,53,177,94,83,2,30,1,1
60176,445,0,0,70,70,0,1,0,1,0
36307,53,54070,53,200,86,114,2,30,1,1
40603,443,49368,443,9462,6402,3060,32,394,11,21
64550,53,62266,53,221,94,127,2,29,1,1
64406,53,3194,53,102,102,0,1,30,1,0
55204,53,55204,53,239,98,141,2,30,1,1
50730,443,7850,443,1323,738,585,10,16,6,4
65313,53,20235,53,802,288,514,8,75,4,4
65379,53,64746,53,376,126,250,2,30,1,1
29706,50584,0,0,66,66,0,1,0,1,0
53844,443,56188,443,499,425,74,4,0,3,1
53238,445,0,0,66,66,0,1,0,1,0
55237,53,6417,53,259,87,172,4,56,2,2
53947,867,6908,867,70,70,0,1,5,1,0
37587,443,50576,443,499,425,74,4,0,3,1
63980,4804,28040,4804,66,66,0,2,8,2,0
49978,53,38632,53,195,102,93,2,29,1,1
2238,22114,0,0,62,62,0,1,0,1,0
60782,20010,60186,20010,70,70,0,2,8,2,0
55544,445,0,0,66,66,0,1,0,1,0
55697,53,51781,53,193,102,91,2,30,1,1
57620,443,56080,443,5177,3010,2167,37,83,17,20
49632,443,35637,443,5598,1185,4413,24,80,13,11
42306,443,42899,443,449862,38989,410873,644,280,286,358
51047,445,0,0,66,66,0,1,0,1,0
51203,445,0,0,70,70,0,1,0,1,0
45964,7776,0,0,60,60,0,1,0,1,0
37965,51413,49792,51413,789,152,637,4,1199,2,2
18415,37965,0,0,62,62,0,1,0,1,0
31994,53,31994,53,244,98,146,2,33,1,1
60725,445,0,0,70,70,0,1,0,1,0
59393,25174,0,0,66,66,0,1,0,1,0
53609,445,0,0,70,70,0,1,0,1,0
59173,445,0,0,66,66,0,1,0,1,0
40408,443,59569,443,6058,1749,4309,22,201,13,9
58345,24748,0,0,148,148,0,1,0,1,0
51274,24399,41980,24399,70,70,0,1,5,1,0
63757,51413,50296,51413,70,70,0,1,4,1,0
36011,25174,0,0,66,66,0,1,0,1,0
34335,23,0,0,60,60,0,1,0,1,0
55282,53,18223,53,771,101,670,2,31,1,1
64087,50265,0,0,145,145,0,1,0,1,0
56758,40000,5881,40000,70,70,0,1,5,1,0
61315,48817,0,0,62,62,0,1,0,1,0
62089,445,0,0,70,70,0,1,0,1,0
64658,53,60447,53,195,102,93,2,29,1,1
56180,53,31487,53,200,102,98,2,30,1,1
60907,443,25513,443,7477,3022,4455,27,45,15,12
49207,58751,6797,58751,70,70,0,2,8,2,0
59840,445,0,0,66,66,0,1,0,1,0
49808,53,25125,53,268,102,166,2,29,1,1
50563,53,11644,53,718,94,624,2,30,1,1
30583,25174,0,0,62,62,0,1,0,1,0
64162,445,0,0,70,70,0,1,0,1,0
10036,44847,0,0,66,66,0,1,0,1,0
49385,443,34796,443,44437,2600,41837,62,16,28,34
49689,22114,0,0,62,62,0,1,0,1,0
45964,55559,0,0,60,60,0,1,0,1,0
55738,445,0,0,66,66,0,1,0,1,0
55559,53,26431,53,180,92,88,2,30,1,1
65291,53,60855,53,335,97,238,4,31,2,2
64415,445,0,0,70,70,0,1,0,1,0
55620,53,23313,53,177,94,83,2,30,1,1
49418,27333,30238,27333,254,78,176,2,30,1,1
53427,443,4839,443,9896,2040,7856,34,120,17,17
57035,53,3817,53,199,102,97,2,30,1,1
4366,51505,0,0,62,62,0,1,0,1,0
59899,3389,59899,3389,3624,1910,1714,19,32,11,8
24351,57470,0,0,62,62,0,1,0,1,0
46491,50584,0,0,66,66,0,1,0,1,0
50922,80,57250,80,9219616,105865,9113751,7687,120,1487,6200
53915,1026,52746,1026,70,70,0,2,8,2,0
56233,80,56233,80,44955,1023,43932,48,15,15,33
56994,80,47420,80,214,140,74,4,35,3,1
54998,53,29340,53,438,89,349,4,60,2,2
56568,53,6901,53,365,105,260,4,47,2,2
57669,64147,0,0,66,66,0,1,0,1,0
49581,445,0,0,70,70,0,1,0,1,0
11919,53,11919,53,213,79,134,2,32,1,1
58593,57470,0,0,62,62,0,1,0,1,0
23461,34021,0,0,62,62,0,1,0,1,0
56919,53,19863,53,186,95,91,2,31,1,1
53267,445,0,0,66,66,0,1,0,1,0
37121,21247,0,0,66,66,0,1,0,1,0
50837,445,0,0,66,66,0,1,0,1,0
18238,53,18238,53,240,96,144,2,30,1,1
9204,443,60040,443,5399,368,5031,18,31,5,13
63839,445,0,0,66,66,0,1,0,1,0
55212,53733,0,0,66,66,0,1,0,1,0
61176,445,0,0,70,70,0,1,0,1,0
54071,50265,0,0,66,66,0,1,0,1,0
25197,1433,0,0,60,60,0,1,0,1,0
39324,64147,0,0,62,62,0,1,0,1,0
13021,25174,0,0,62,62,0,1,0,1,0
55351,445,0,0,66,66,0,1,0,1,0
55675,53,24009,53,195,102,93,2,30,1,1
47595,33437,0,0,106,106,0,1,61,1,0
64899,53,5067,53,199,102,97,2,31,1,1
55632,445,0,0,70,70,0,1,0,1,0
61286,443,41653,443,248071,7320,240751,269,268,89,180
49729,53,55522,53,210,102,108,2,30,1,1
51311,445,0,0,70,70,0,1,0,1,0
49794,53,1835,53,197,102,95,2,30,1,1
64093,64828,53558,64828,70,70,0,1,4,1,0
40464,80,50769,80,15535,2173,13362,30,21,17,13
55919,53,46329,53,177,94,83,2,31,1,1
60073,80,45095,80,10676,6719,3957,23,141,12,11
52508,445,0,0,66,66,0,1,0,1,0
63551,445,0,0,70,70,0,1,0,1,0
37075,48817,0,0,62,62,0,1,0,1,0
63949,53,30252,53,195,102,93,2,31,1,1
49599,53,2987,53,732,86,646,2,29,1,1
64117,445,0,0,70,70,0,1,0,1,0
56006,53,57116,53,183,102,81,2,29,1,1
59937,443,15432,443,7701,3981,3720,27,70,12,15
63262,445,0,0,70,70,0,1,0,1,0
49473,53,57880,53,290,118,172,2,30,1,1
58329,62413,0,0,62,62,0,1,0,1,0
64908,53,50064,53,812,110,702,2,30,1,1
35570,22114,0,0,62,62,0,1,0,1,0
8194,21247,0,0,146,146,0,1,0,1,0
49710,53,33849,53,183,102,81,2,30,1,1
51101,445,0,0,66,66,0,1,0,1,0
62400,35993,0,0,66,66,0,1,0,1,0
60342,36237,0,0,66,66,0,1,0,1,0
57470,65534,12773,65534,773,271,502,4,1200,2,2
53118,443,63279,443,21933,11660,10273,206,188,114,92
49954,53,53212,53,216,110,106,2,29,1,1
49562,80,14517,80,318,192,126,6,45,4,2
52676,53733,0,0,66,66,0,1,0,1,0
56523,443,55087,443,8130,2093,6037,17,120,9,8
11023,51505,0,0,66,66,0,1,0,1,0
55110,445,0,0,66,66,0,1,0,1,0
44849,46478,0,0,74,74,0,1,0,1,0
64133,53,32044,53,216,102,114,2,30,1,1
50415,445,0,0,70,70,0,1,0,1,0
49543,445,0,0,66,66,0,1,0,1,0
49290,443,20906,443,1629306,22920,1606386,1339,116,262,1077
58638,5900,0,0,62,62,0,1,0,1,0
58521,445,0,0,70,70,0,1,0,1,0
58298,445,0,0,70,70,0,1,0,1,0
62551,445,0,0,66,66,0,1,0,1,0
52129,55550,12680,55550,70,70,0,2,8,2,0
52127,44198,61078,44198,70,70,0,1,5,1,0
64928,53,11072,53,762,98,664,2,30,1,1
63837,14023,10553,14023,66,66,0,2,8,2,0
53724,64923,63918,64923,70,70,0,1,5,1,0
56455,53,54287,53,183,94,89,2,31,1,1
62148,37965,0,0,62,62,0,1,0,1,0
3478,61463,0,0,893,893,0,1,0,1,0
60400,80,41884,80,1704,808,896,10,122,6,4
27005,27017,62934,27017,1658,126,1532,4,30,2,2
61278,56205,0,0,66,66,0,1,0,1,0
55755,53,57482,53,779,86,693,2,30,1,1
64677,53,37767,53,182,93,89,2,31,1,1
55232,25174,0,0,146,146,0,1,0,1,0
49155,443,35211,443,8941,1776,7165,22,136,12,10
50672,445,0,0,70,70,0,1,0,1,0
54943,60038,0,0,66,66,0,1,90,1,0
13159,37965,0,0,66,66,0,1,0,1,0
50713,57470,0,0,66,66,0,1,0,1,0
17760,50584,0,0,62,62,0,1,0,1,0
53759,40826,3442,40826,492,306,186,8,15,5,3
64432,53,45713,53,168,86,82,2,30,1,1
62392,15503,0,0,146,146,0,1,0,1,0
52630,445,0,0,70,70,0,1,0,1,0
61091,443,61091,443,18924,5378,13546,33,18,19,14
49396,53,60623,53,216,102,114,2,30,1,1
55920,53,34293,53,810,108,702,2,31,1,1
45964,2225,0,0,60,60,0,1,0,1,0
26805,443,51812,443,7343,2586,4757,23,20,11,12
55708,445,0,0,70,70,0,1,0,1,0
54199,443,31908,443,499,425,74,4,0,3,1
50943,445,0,0,70,70,0,1,0,1,0
45764,443,11581,443,57543,2347,55196,68,16,26,42
64649,53,56977,53,184,94,90,2,30,1,1
9219,32480,0,0,72,72,0,1,0,1,0
57072,53,14779,53,195,102,93,2,30,1,1
37965,6881,16163,6881,452,248,204,4,1199,2,2
49325,443,26750,443,5749,3401,2348,29,76,15,14
49420,443,13090,443,5241,1194,4047,19,40,9,10
42298,40005,19733,40005,148,86,62,2,30,1,1
57730,445,0,0,70,70,0,1,0,1,0
60375,53,25105,53,226,94,132,2,31,1,1
15333,60043,0,0,62,62,0,1,0,1,0
11136,15503,0,0,62,62,0,1,0,1,0
53036,80,53036,80,2954,720,2234,13,143,6,7
64128,445,0,0,70,70,0,1,0,1,0
33852,443,7849,443,3419,2241,1178,16,16,8,8
58021,443,29855,443,8075,4109,3966,42,91,19,23
63060,53,7236,53,304,86,218,2,30,1,1
56828,53,33245,53,211,102,109,2,30,1,1
32215,22114,0,0,66,66,0,1,0,1,0
60710,445,0,0,66,66,0,1,0,1,0
64433,53,29795,53,214,102,112,2,30,1,1
58968,445,0,0,70,70,0,1,0,1,0
58250,35440,0,0,62,62,0,1,0,1,0
53590,8999,22601,8999,1207,605,602,10,25,5,5
1924,80,29370,80,214,140,74,4,15,3,1
49308,53,4514,53,195,102,93,2,30,1,1
56360,53,26019,53,184,102,82,2,30,1,1
55072,53,50967,53,177,94,83,2,31,1,1
58638,5900,0,0,62,62,0,1,0,1,0
64517,53,41461,53,211,102,109,2,30,1,1
64273,53,36287,53,239,94,145,2,30,1,1
56951,443,25621,443,4679,2071,2608,14,135,7,7
65360,445,0,0,70,70,0,1,0,1,0
61846,445,0,0,66,66,0,1,0,1,0
49971,53,55758,53,198,102,96,2,30,1,1
6712,44818,0,0,66,66,0,1,0,1,0
62546,443,43210,443,7740,2603,5137,13,120,7,6
59544,445,0,0,70,70,0,1,0,1,0
49247,53,64384,53,776,283,493,8,82,4,4
58955,80,51848,80,3037,2276,761,12,28,7,5
49855,53,48096,53,177,94,83,2,30,1,1
20844,64147,0,0,66,66,0,1,0,1,0
62299,445,0,0,70,70,0,1,0,1,0
49501,11392,0,0,66,66,0,1,0,1,0
27005,27237,36473,27237,876,126,750,2,30,1,1
42732,57470,0,0,62,62,0,1,0,1,0
52291,445,0,0,70,70,0,1,0,1,0
45964,3111,0,0,60,60,0,1,0,1,0
55704,53,10411,53,177,94,83,2,31,1,1
17251,10387,0,0,159,159,0,1,0,1,0
42463,56205,0,0,62,62,0,1,0,1,0
27328,21247,0,0,66,66,0,1,0,1,0
41693,443,28921,443,27069,3064,24005,44,178,19,25
65451,53,3084,53,728,234,494,6,67,3,3
54301,445,0,0,70,70,0,1,0,1,0
55056,44512,0,0,62,62,0,1,0,1,0
58724,43890,0,0,66,66,0,1,0,1,0
